,Date,HomeTeam,AwayTeam,FTHG,FTAG,FTR,Date_interval,HTGS,ATGS,HTGC,ATGC,HTGD,ATGD,HTP,ATP,PtDiff
0,2005-08-13,Aston Villa,Bolton,2,2,D,2005-08-13,2,2,2,2,0,0,1,1,0
1,2005-08-13,Everton,Man United,0,2,A,2005-08-13,0,2,2,2,-2,0,0,3,-3
2,2005-08-13,Fulham,Birmingham,0,0,D,2005-08-13,0,0,0,0,0,0,1,1,0
3,2005-08-13,Man City,West Brom,0,0,D,2005-08-13,0,0,0,0,0,0,1,1,0
4,2005-08-13,Middlesbrough,Liverpool,0,0,D,2005-08-13,0,0,0,0,0,0,1,1,0
5,2005-08-13,Portsmouth,Tottenham,0,2,A,2005-08-13,0,2,2,2,-2,0,0,3,-3
6,2005-08-13,Sunderland,Charlton,1,3,A,2005-08-13,1,3,3,3,-2,0,0,3,-3
7,2005-08-13,West Ham,Blackburn,3,1,H,2005-08-13,3,1,1,1,2,0,3,0,3
8,2005-08-14,Arsenal,Newcastle,2,0,H,2005-08-20,2,0,0,0,2,0,3,0,3
9,2005-08-14,Wigan,Chelsea,0,1,A,2005-08-20,0,1,2,2,-2,-1,0,3,-3
10,2005-08-20,Birmingham,Man City,1,2,A,2005-08-20,1,2,2,2,-1,0,0,3,-3
11,2005-08-20,Blackburn,Fulham,2,1,H,2005-08-20,2,1,1,1,1,0,3,0,3
12,2005-08-20,Charlton,Wigan,1,0,H,2005-08-20,1,0,0,0,1,0,3,0,3
13,2005-08-20,Liverpool,Sunderland,1,0,H,2005-08-20,1,0,0,0,1,0,3,0,3
14,2005-08-20,Man United,Aston Villa,1,0,H,2005-08-20,1,0,0,0,1,0,3,0,3
15,2005-08-20,Newcastle,West Ham,0,0,D,2005-08-20,0,0,2,2,-2,-2,1,1,0
16,2005-08-20,Tottenham,Middlesbrough,2,0,H,2005-08-20,2,0,0,0,2,0,3,0,3
17,2005-08-20,West Brom,Portsmouth,2,1,H,2005-08-20,2,1,1,1,1,0,3,0,3
18,2005-08-21,Bolton,Everton,0,1,A,2005-08-27,4,1,2,2,2,-1,3,3,0
19,2005-08-21,Chelsea,Arsenal,1,0,H,2005-08-27,7,4,0,0,7,4,6,0,6
20,2005-08-23,Birmingham,Middlesbrough,0,3,A,2005-08-27,3,3,5,5,-2,-2,0,3,-3
21,2005-08-23,Portsmouth,Aston Villa,1,1,D,2005-08-27,2,2,3,3,-1,-1,1,1,0
22,2005-08-23,Sunderland,Man City,1,2,A,2005-08-27,1,4,3,3,-2,1,0,3,-3
23,2005-08-24,Arsenal,Fulham,4,1,H,2005-08-27,4,2,2,2,2,0,3,0,3
24,2005-08-24,Blackburn,Tottenham,0,0,D,2005-08-27,0,0,1,1,-1,-1,1,1,0
25,2005-08-24,Bolton,Newcastle,2,0,H,2005-08-27,4,0,2,2,2,-2,3,0,3
26,2005-08-24,Chelsea,West Brom,4,0,H,2005-08-27,7,2,0,0,7,2,6,0,6
27,2005-08-27,Aston Villa,Blackburn,1,0,H,2005-08-27,2,0,1,1,1,-1,3,0,3
28,2005-08-27,Fulham,Everton,1,0,H,2005-08-27,2,1,4,4,-2,-3,3,3,0
29,2005-08-27,Man City,Portsmouth,2,1,H,2005-08-27,4,2,2,2,2,0,3,0,3
30,2005-08-27,Tottenham,Chelsea,0,2,A,2005-08-27,0,7,2,2,-2,5,0,3,-3
31,2005-08-27,West Brom,Birmingham,2,3,A,2005-08-27,2,3,7,7,-5,-4,0,3,-3
32,2005-08-27,West Ham,Bolton,1,2,A,2005-08-27,1,4,2,2,-1,2,0,3,-3
33,2005-08-27,Wigan,Sunderland,1,0,H,2005-08-27,1,1,0,0,1,1,3,0,3
34,2005-08-28,Middlesbrough,Charlton,0,3,A,2005-09-03,0,3,3,3,-3,0,0,3,-3
35,2005-08-28,Newcastle,Man United,0,2,A,2005-09-03,0,2,2,2,-2,0,0,3,-3
36,2005-09-10,Birmingham,Charlton,0,1,A,2005-09-10,0,1,1,1,-1,0,0,3,-3
37,2005-09-10,Chelsea,Sunderland,2,0,H,2005-09-10,2,0,0,0,2,0,3,0,3
38,2005-09-10,Everton,Portsmouth,0,1,A,2005-09-10,0,1,1,1,-1,0,0,3,-3
39,2005-09-10,Man United,Man City,1,1,D,2005-09-10,1,1,1,1,0,0,1,1,0
40,2005-09-10,Middlesbrough,Arsenal,2,1,H,2005-09-10,2,1,1,1,1,0,3,0,3
41,2005-09-10,Newcastle,Fulham,1,1,D,2005-09-10,1,1,1,1,0,0,1,1,0
42,2005-09-10,Tottenham,Liverpool,0,0,D,2005-09-10,0,0,0,0,0,0,1,1,0
43,2005-09-10,West Brom,Wigan,1,2,A,2005-09-10,1,2,2,2,-1,0,0,3,-3
44,2005-09-11,Bolton,Blackburn,0,0,D,2005-09-17,0,0,0,0,0,0,1,1,0
45,2005-09-12,West Ham,Aston Villa,4,0,H,2005-09-17,6,1,1,1,5,0,3,0,3
46,2005-09-17,Aston Villa,Tottenham,1,1,D,2005-09-17,1,1,5,5,-4,-4,1,1,0
47,2005-09-17,Charlton,Chelsea,0,2,A,2005-09-17,0,2,2,2,-2,0,0,3,-3
48,2005-09-17,Fulham,West Ham,1,2,A,2005-09-17,1,6,2,2,-1,4,0,3,-3
49,2005-09-17,Portsmouth,Birmingham,1,1,D,2005-09-17,1,1,1,1,0,0,1,1,0
50,2005-09-17,Sunderland,West Brom,1,1,D,2005-09-17,1,1,1,1,0,0,1,1,0
51,2005-09-18,Blackburn,Newcastle,0,3,A,2005-09-24,2,4,4,4,-2,0,0,3,-3
52,2005-09-18,Liverpool,Man United,0,0,D,2005-09-24,2,1,2,2,0,-1,1,1,0
53,2005-09-18,Man City,Bolton,0,1,A,2005-09-24,0,2,2,2,-2,0,0,3,-3
54,2005-09-18,Wigan,Middlesbrough,1,1,D,2005-09-24,2,1,1,1,1,0,1,1,0
55,2005-09-19,Arsenal,Everton,2,0,H,2005-09-24,2,0,0,0,2,0,3,0,3
56,2005-09-24,Birmingham,Liverpool,2,2,D,2005-09-24,2,2,2,2,0,0,1,1,0
57,2005-09-24,Bolton,Portsmouth,1,0,H,2005-09-24,2,0,0,0,2,0,3,0,3
58,2005-09-24,Chelsea,Aston Villa,2,1,H,2005-09-24,2,1,1,1,1,0,3,0,3
59,2005-09-24,Everton,Wigan,0,1,A,2005-09-24,0,2,3,3,-3,-1,0,3,-3
60,2005-09-24,Man United,Blackburn,1,2,A,2005-09-24,1,2,2,2,-1,0,0,3,-3
61,2005-09-24,Newcastle,Man City,1,0,H,2005-09-24,4,0,0,0,4,0,3,0,3
62,2005-09-24,West Brom,Charlton,1,2,A,2005-09-24,1,2,2,2,-1,0,0,3,-3
63,2005-09-24,West Ham,Arsenal,0,0,D,2005-09-24,0,2,0,0,0,2,1,1,0
64,2005-09-25,Middlesbrough,Sunderland,0,2,A,2005-10-01,0,3,2,2,-2,1,0,3,-3
65,2005-09-26,Tottenham,Fulham,1,0,H,2005-10-01,4,2,2,2,2,0,3,0,3
66,2005-10-01,Blackburn,West Brom,2,0,H,2005-10-01,2,0,0,0,2,0,3,0,3
67,2005-10-01,Charlton,Tottenham,2,3,A,2005-10-01,2,4,3,3,-1,1,0,3,-3
68,2005-10-01,Fulham,Man United,2,3,A,2005-10-01,2,3,4,4,-2,-1,0,3,-3
69,2005-10-01,Portsmouth,Newcastle,0,0,D,2005-10-01,0,0,0,0,0,0,1,1,0
70,2005-10-01,Sunderland,West Ham,1,1,D,2005-10-01,3,1,1,1,2,0,1,1,0
71,2005-10-02,Arsenal,Birmingham,1,0,H,2005-10-08,1,0,0,0,1,0,3,0,3
72,2005-10-02,Aston Villa,Middlesbrough,2,3,A,2005-10-08,2,3,3,3,-1,0,0,3,-3
73,2005-10-02,Liverpool,Chelsea,1,4,A,2005-10-08,1,4,4,4,-3,0,0,3,-3
74,2005-10-02,Man City,Everton,2,0,H,2005-10-08,2,0,0,0,2,0,3,0,3
75,2005-10-02,Wigan,Bolton,2,1,H,2005-10-08,2,1,1,1,1,0,3,0,3
76,2005-10-15,Chelsea,Bolton,5,1,H,2005-10-15,5,1,1,1,4,0,3,0,3
77,2005-10-15,Liverpool,Blackburn,1,0,H,2005-10-15,1,0,0,0,1,0,3,0,3
78,2005-10-15,Middlesbrough,Portsmouth,1,1,D,2005-10-15,1,1,1,1,0,0,1,1,0
79,2005-10-15,Sunderland,Man United,1,3,A,2005-10-15,1,3,3,3,-2,0,0,3,-3
80,2005-10-15,Tottenham,Everton,2,0,H,2005-10-15,2,0,0,0,2,0,3,0,3
81,2005-10-15,West Brom,Arsenal,2,1,H,2005-10-15,2,1,1,1,1,0,3,0,3
82,2005-10-15,Wigan,Newcastle,1,0,H,2005-10-15,1,0,0,0,1,0,3,0,3
83,2005-10-16,Birmingham,Aston Villa,0,1,A,2005-10-22,0,1,3,3,-3,-2,0,3,-3
84,2005-10-16,Man City,West Ham,2,1,H,2005-10-22,2,1,2,2,0,-1,3,0,3
85,2005-10-17,Charlton,Fulham,1,1,D,2005-10-22,3,3,2,2,1,1,1,1,0
86,2005-10-22,Arsenal,Man City,1,0,H,2005-10-22,1,2,0,0,1,2,3,0,3
87,2005-10-22,Aston Villa,Wigan,0,2,A,2005-10-22,1,2,2,2,-1,0,0,3,-3
88,2005-10-22,Blackburn,Birmingham,2,0,H,2005-10-22,2,0,0,0,2,0,3,0,3
89,2005-10-22,Fulham,Liverpool,2,0,H,2005-10-22,3,0,1,1,2,-1,3,0,3
90,2005-10-22,Man United,Tottenham,1,1,D,2005-10-22,1,1,1,1,0,0,1,1,0
91,2005-10-22,Portsmouth,Charlton,1,2,A,2005-10-22,1,3,2,2,-1,1,0,3,-3
92,2005-10-23,Bolton,West Brom,2,0,H,2005-10-29,3,0,0,0,3,0,3,0,3
93,2005-10-23,Everton,Chelsea,1,1,D,2005-10-29,2,5,1,1,1,4,1,1,0
94,2005-10-23,Newcastle,Sunderland,3,2,H,2005-10-29,3,3,2,2,1,1,3,0,3
95,2005-10-23,West Ham,Middlesbrough,2,1,H,2005-10-29,2,5,3,3,-1,2,3,0,3
96,2005-10-29,Birmingham,Everton,0,1,A,2005-10-29,0,2,1,1,-1,1,0,3,-3
97,2005-10-29,Charlton,Bolton,0,1,A,2005-10-29,0,3,1,1,-1,2,0,3,-3
98,2005-10-29,Chelsea,Blackburn,4,2,H,2005-10-29,5,2,3,3,2,-1,3,0,3
99,2005-10-29,Liverpool,West Ham,2,0,H,2005-10-29,2,2,0,0,2,2,3,0,3
100,2005-10-29,Middlesbrough,Man United,4,1,H,2005-10-29,5,1,3,3,2,-2,3,0,3
101,2005-10-29,Sunderland,Portsmouth,1,4,A,2005-10-29,3,4,7,7,-4,-3,0,3,-3
102,2005-10-29,Tottenham,Arsenal,1,1,D,2005-10-29,1,1,1,1,0,0,1,1,0
103,2005-10-29,Wigan,Fulham,1,0,H,2005-10-29,1,0,0,0,1,0,3,0,3
104,2005-10-30,West Brom,Newcastle,0,3,A,2005-11-05,0,4,4,4,-4,0,0,3,-3
105,2005-10-31,Man City,Aston Villa,3,1,H,2005-11-05,4,1,3,3,1,-2,3,0,3
106,2005-11-05,Arsenal,Sunderland,3,1,H,2005-11-05,3,1,1,1,2,0,3,0,3
107,2005-11-05,Aston Villa,Liverpool,0,2,A,2005-11-05,1,2,5,5,-4,-3,0,3,-3
108,2005-11-05,Blackburn,Charlton,4,1,H,2005-11-05,4,1,1,1,3,0,3,0,3
109,2005-11-05,Fulham,Man City,2,1,H,2005-11-05,2,4,1,1,1,3,3,0,3
110,2005-11-05,Newcastle,Birmingham,1,0,H,2005-11-05,4,0,0,0,4,0,3,0,3
111,2005-11-05,Portsmouth,Wigan,0,2,A,2005-11-05,0,2,2,2,-2,0,0,3,-3
112,2005-11-05,West Ham,West Brom,1,0,H,2005-11-05,1,0,0,0,1,0,3,0,3
113,2005-11-06,Everton,Middlesbrough,1,0,H,2005-11-12,1,0,0,0,1,0,3,0,3
114,2005-11-06,Man United,Chelsea,1,0,H,2005-11-12,1,0,0,0,1,0,3,0,3
115,2005-11-07,Bolton,Tottenham,1,0,H,2005-11-12,1,0,0,0,1,0,3,0,3
116,2005-11-19,Charlton,Man United,1,3,A,2005-11-19,1,3,3,3,-2,0,0,3,-3
117,2005-11-19,Chelsea,Newcastle,3,0,H,2005-11-19,3,0,0,0,3,0,3,0,3
118,2005-11-19,Liverpool,Portsmouth,3,0,H,2005-11-19,3,0,0,0,3,0,3,0,3
119,2005-11-19,Man City,Blackburn,0,0,D,2005-11-19,0,0,0,0,0,0,1,1,0
120,2005-11-19,Sunderland,Aston Villa,1,3,A,2005-11-19,1,3,3,3,-2,0,0,3,-3
121,2005-11-19,West Brom,Everton,4,0,H,2005-11-19,4,0,0,0,4,0,3,0,3
122,2005-11-19,Wigan,Arsenal,2,3,A,2005-11-19,2,3,3,3,-1,0,0,3,-3
123,2005-11-20,Middlesbrough,Fulham,3,2,H,2005-11-26,3,2,2,2,1,0,3,0,3
124,2005-11-20,Tottenham,West Ham,1,1,D,2005-11-26,3,1,2,2,1,-1,1,1,0
125,2005-11-26,Arsenal,Blackburn,3,0,H,2005-11-26,3,0,0,0,3,0,3,0,3
126,2005-11-26,Aston Villa,Charlton,1,0,H,2005-11-26,1,0,0,0,1,0,3,0,3
127,2005-11-26,Man City,Liverpool,0,1,A,2005-11-26,0,1,1,1,-1,0,0,3,-3
128,2005-11-26,Portsmouth,Chelsea,0,2,A,2005-11-26,0,2,2,2,-2,0,0,3,-3
129,2005-11-26,Sunderland,Birmingham,0,1,A,2005-11-26,0,1,1,1,-1,0,0,3,-3
130,2005-11-26,Wigan,Tottenham,1,2,A,2005-11-26,1,3,2,2,-1,1,0,3,-3
131,2005-11-27,Everton,Newcastle,1,0,H,2005-12-03,3,1,0,0,3,1,3,0,3
132,2005-11-27,Fulham,Bolton,2,1,H,2005-12-03,2,3,1,1,1,2,3,0,3
133,2005-11-27,Middlesbrough,West Brom,2,2,D,2005-12-03,2,2,3,3,-1,-1,1,1,0
134,2005-11-27,West Ham,Man United,1,2,A,2005-12-03,1,5,2,2,-1,3,0,3,-3
135,2005-11-30,Sunderland,Liverpool,0,2,A,2005-12-03,2,5,5,5,-3,0,0,3,-3
136,2005-12-03,Blackburn,Everton,0,2,A,2005-12-03,0,3,2,2,-2,1,0,3,-3
137,2005-12-03,Bolton,Arsenal,2,0,H,2005-12-03,3,0,2,2,1,-2,3,0,3
138,2005-12-03,Chelsea,Middlesbrough,1,0,H,2005-12-03,1,2,0,0,1,2,3,0,3
139,2005-12-03,Liverpool,Wigan,3,0,H,2005-12-03,5,0,0,0,5,0,3,0,3
140,2005-12-03,Man United,Portsmouth,3,0,H,2005-12-03,5,0,1,1,4,-1,3,0,3
141,2005-12-03,Newcastle,Aston Villa,1,1,D,2005-12-03,1,1,2,2,-1,-1,1,1,0
142,2005-12-03,Tottenham,Sunderland,3,2,H,2005-12-03,3,2,2,2,1,0,3,0,3
143,2005-12-03,West Brom,Fulham,0,0,D,2005-12-03,2,2,2,2,0,0,1,1,0
144,2005-12-04,Charlton,Man City,2,5,A,2005-12-10,4,5,5,5,-1,0,3,3,0
145,2005-12-05,Birmingham,West Ham,1,2,A,2005-12-10,2,4,2,2,0,2,3,3,0
146,2005-12-10,Birmingham,Fulham,1,0,H,2005-12-10,2,0,2,2,0,-2,3,0,3
147,2005-12-10,Blackburn,West Ham,3,2,H,2005-12-10,3,4,2,2,1,2,3,3,0
148,2005-12-10,Bolton,Aston Villa,1,1,D,2005-12-10,1,1,1,1,0,0,1,1,0
149,2005-12-10,Charlton,Sunderland,2,0,H,2005-12-10,4,0,5,5,-1,-5,3,0,3
150,2005-12-10,Chelsea,Wigan,1,0,H,2005-12-10,1,0,0,0,1,0,3,0,3
151,2005-12-10,Liverpool,Middlesbrough,2,0,H,2005-12-10,2,0,0,0,2,0,3,0,3
152,2005-12-10,Newcastle,Arsenal,1,0,H,2005-12-10,1,0,0,0,1,0,3,0,3
153,2005-12-10,West Brom,Man City,2,0,H,2005-12-10,2,5,0,0,2,5,3,3,0
154,2005-12-11,Man United,Everton,1,1,D,2005-12-17,7,2,1,1,6,1,4,1,3
155,2005-12-12,Tottenham,Portsmouth,3,1,H,2005-12-17,3,2,1,1,2,1,3,0,3
156,2005-12-14,Everton,West Ham,1,2,A,2005-12-17,2,4,7,7,-5,-3,0,3,-3
157,2005-12-14,Man United,Wigan,4,0,H,2005-12-17,7,3,1,1,6,2,4,0,4
158,2005-12-17,Aston Villa,Man United,0,2,A,2005-12-17,0,7,2,2,-2,5,0,3,-3
159,2005-12-17,Everton,Bolton,0,4,A,2005-12-17,2,4,7,7,-5,-3,0,3,-3
160,2005-12-17,Fulham,Blackburn,2,1,H,2005-12-17,2,1,1,1,1,0,3,0,3
161,2005-12-17,Man City,Birmingham,4,1,H,2005-12-17,4,1,1,1,3,0,3,0,3
162,2005-12-17,Portsmouth,West Brom,1,0,H,2005-12-17,2,0,3,3,-1,-3,3,0,3
163,2005-12-17,West Ham,Newcastle,2,4,A,2005-12-17,4,4,5,5,-1,-1,0,3,-3
164,2005-12-17,Wigan,Charlton,3,0,H,2005-12-17,3,0,4,4,-1,-4,3,0,3
165,2005-12-18,Arsenal,Chelsea,0,2,A,2005-12-24,0,2,2,2,-2,0,0,3,-3
166,2005-12-18,Middlesbrough,Tottenham,3,3,D,2005-12-24,3,3,3,3,0,0,1,1,0
167,2005-12-26,Aston Villa,Everton,4,0,H,2005-12-31,7,2,3,3,4,-1,4,3,1
168,2005-12-26,Charlton,Arsenal,0,1,A,2005-12-31,2,5,1,1,1,4,3,4,-1
169,2005-12-26,Chelsea,Fulham,3,2,H,2005-12-31,6,5,2,2,4,3,6,0,6
170,2005-12-26,Liverpool,Newcastle,2,0,H,2005-12-31,6,0,1,1,5,-1,6,0,6
171,2005-12-26,Man United,West Brom,3,0,H,2005-12-31,9,2,3,3,6,-1,6,0,6
172,2005-12-26,Middlesbrough,Blackburn,0,2,A,2005-12-31,0,5,2,2,-2,3,1,6,-5
173,2005-12-26,Portsmouth,West Ham,1,1,D,2005-12-31,2,1,5,5,-3,-4,4,1,3
174,2005-12-26,Sunderland,Bolton,0,0,D,2005-12-31,0,1,1,1,-1,0,1,1,0
175,2005-12-26,Tottenham,Birmingham,2,0,H,2005-12-31,4,2,2,2,2,0,6,0,6
176,2005-12-26,Wigan,Man City,4,3,H,2005-12-31,6,3,6,6,0,-3,3,1,2
177,2005-12-28,Arsenal,Portsmouth,4,0,H,2005-12-31,5,2,0,0,5,2,3,0,3
178,2005-12-28,Birmingham,Man United,2,2,D,2005-12-31,2,9,6,6,-4,3,1,1,0
179,2005-12-28,Everton,Liverpool,1,3,A,2005-12-31,2,6,7,7,-5,-1,0,3,-3
180,2005-12-28,Fulham,Aston Villa,3,3,D,2005-12-31,5,7,7,7,-2,0,1,1,0
181,2005-12-28,Man City,Chelsea,0,1,A,2005-12-31,3,6,5,5,-2,1,0,3,-3
182,2005-12-28,West Brom,Tottenham,2,0,H,2005-12-31,2,4,4,4,-2,0,3,0,3
183,2005-12-28,West Ham,Wigan,0,2,A,2005-12-31,1,6,5,5,-4,1,0,3,-3
184,2005-12-31,Aston Villa,Arsenal,0,0,D,2005-12-31,7,5,3,3,4,2,4,4,0
185,2005-12-31,Charlton,West Ham,2,0,H,2005-12-31,2,1,1,1,1,0,3,1,2
186,2005-12-31,Chelsea,Birmingham,2,0,H,2005-12-31,6,2,2,2,4,0,6,0,6
187,2005-12-31,Liverpool,West Brom,1,0,H,2005-12-31,6,2,1,1,5,1,6,0,6
188,2005-12-31,Man United,Bolton,4,1,H,2005-12-31,9,1,3,3,6,-2,6,1,5
189,2005-12-31,Middlesbrough,Man City,0,0,D,2005-12-31,0,3,2,2,-2,1,1,1,0
190,2005-12-31,Portsmouth,Fulham,1,0,H,2005-12-31,2,5,5,5,-3,0,4,0,4
191,2005-12-31,Sunderland,Everton,0,1,A,2005-12-31,0,2,1,1,-1,1,1,3,-2
192,2005-12-31,Tottenham,Newcastle,2,0,H,2005-12-31,4,0,2,2,2,-2,6,0,6
193,2005-12-31,Wigan,Blackburn,0,3,A,2005-12-31,6,5,6,6,0,-1,3,6,-3
194,2006-01-02,Birmingham,Wigan,2,0,H,2006-01-07,2,0,0,0,2,0,3,0,3
195,2006-01-02,Blackburn,Portsmouth,2,1,H,2006-01-07,2,1,1,1,1,0,3,0,3
196,2006-01-02,Bolton,Liverpool,2,2,D,2006-01-07,2,2,2,2,0,0,1,1,0
197,2006-01-02,Everton,Charlton,3,1,H,2006-01-07,3,1,1,1,2,0,3,0,3
198,2006-01-02,Fulham,Sunderland,2,1,H,2006-01-07,2,1,1,1,1,0,3,0,3
199,2006-01-02,Newcastle,Middlesbrough,2,2,D,2006-01-07,2,2,2,2,0,0,1,1,0
200,2006-01-02,West Brom,Aston Villa,1,2,A,2006-01-07,1,2,2,2,-1,0,0,3,-3
201,2006-01-02,West Ham,Chelsea,1,3,A,2006-01-07,1,3,3,3,-2,0,0,3,-3
202,2006-01-03,Arsenal,Man United,0,0,D,2006-01-07,0,0,0,0,0,0,1,1,0
203,2006-01-04,Man City,Tottenham,0,2,A,2006-01-07,0,2,2,2,-2,0,0,3,-3
204,2006-01-14,Arsenal,Middlesbrough,7,0,H,2006-01-14,7,0,0,0,7,0,3,0,3
205,2006-01-14,Aston Villa,West Ham,1,2,A,2006-01-14,1,2,2,2,-1,0,0,3,-3
206,2006-01-14,Blackburn,Bolton,0,0,D,2006-01-14,0,0,0,0,0,0,1,1,0
207,2006-01-14,Charlton,Birmingham,2,0,H,2006-01-14,2,0,0,0,2,0,3,0,3
208,2006-01-14,Fulham,Newcastle,1,0,H,2006-01-14,1,0,0,0,1,0,3,0,3
209,2006-01-14,Liverpool,Tottenham,1,0,H,2006-01-14,1,0,0,0,1,0,3,0,3
210,2006-01-14,Man City,Man United,3,1,H,2006-01-14,3,1,1,1,2,0,3,0,3
211,2006-01-14,Portsmouth,Everton,0,1,A,2006-01-14,0,1,1,1,-1,0,0,3,-3
212,2006-01-15,Sunderland,Chelsea,1,2,A,2006-01-21,2,2,2,2,0,0,0,3,-3
213,2006-01-15,Wigan,West Brom,0,1,A,2006-01-21,3,1,3,3,0,-2,0,3,-3
214,2006-01-21,Birmingham,Portsmouth,5,0,H,2006-01-21,5,0,0,0,5,0,3,0,3
215,2006-01-21,Bolton,Man City,2,0,H,2006-01-21,2,0,0,0,2,0,3,0,3
216,2006-01-21,Everton,Arsenal,1,0,H,2006-01-21,1,0,0,0,1,0,3,0,3
217,2006-01-21,Middlesbrough,Wigan,2,3,A,2006-01-21,2,3,3,3,-1,0,0,3,-3
218,2006-01-21,Newcastle,Blackburn,0,1,A,2006-01-21,0,1,1,1,-1,0,0,3,-3
219,2006-01-21,Tottenham,Aston Villa,0,0,D,2006-01-21,0,0,0,0,0,0,1,1,0
220,2006-01-21,West Brom,Sunderland,0,1,A,2006-01-21,1,2,1,1,0,1,0,3,-3
221,2006-01-22,Chelsea,Charlton,1,1,D,2006-01-28,1,1,1,1,0,0,1,1,0
222,2006-01-22,Man United,Liverpool,1,0,H,2006-01-28,1,0,0,0,1,0,3,0,3
223,2006-01-23,West Ham,Fulham,2,1,H,2006-01-28,2,1,1,1,1,0,3,0,3
224,2006-01-31,Charlton,West Brom,0,0,D,2006-02-04,0,2,0,0,0,2,1,1,0
225,2006-01-31,Fulham,Tottenham,1,0,H,2006-02-04,3,0,4,4,-1,-4,3,0,3
226,2006-01-31,Sunderland,Middlesbrough,0,3,A,2006-02-04,0,3,5,5,-5,-2,0,3,-3
227,2006-01-31,Wigan,Everton,1,1,D,2006-02-04,2,2,2,2,0,0,1,1,0
228,2006-02-01,Arsenal,West Ham,2,3,A,2006-02-04,4,5,3,3,1,2,0,3,-3
229,2006-02-01,Aston Villa,Chelsea,1,1,D,2006-02-04,5,1,1,1,4,0,1,1,0
230,2006-02-01,Blackburn,Man United,4,3,H,2006-02-04,4,7,5,5,-1,2,3,0,3
231,2006-02-01,Liverpool,Birmingham,1,1,D,2006-02-04,1,1,1,1,0,0,1,1,0
232,2006-02-01,Man City,Newcastle,3,0,H,2006-02-04,3,2,1,1,2,1,3,0,3
233,2006-02-01,Portsmouth,Bolton,1,1,D,2006-02-04,1,2,3,3,-2,-1,1,1,0
234,2006-02-04,Birmingham,Arsenal,0,2,A,2006-02-04,1,4,3,3,-2,1,0,3,-3
235,2006-02-04,Bolton,Wigan,1,1,D,2006-02-04,2,2,2,2,0,0,1,1,0
236,2006-02-04,Everton,Man City,1,0,H,2006-02-04,2,3,1,1,1,2,3,0,3
237,2006-02-04,Man United,Fulham,4,2,H,2006-02-04,7,3,6,6,1,-3,3,0,3
238,2006-02-04,Middlesbrough,Aston Villa,0,4,A,2006-02-04,3,5,4,4,-1,1,0,3,-3
239,2006-02-04,Newcastle,Portsmouth,2,0,H,2006-02-04,2,1,3,3,-1,-2,3,0,3
240,2006-02-04,West Brom,Blackburn,2,0,H,2006-02-04,2,4,0,0,2,4,3,0,3
241,2006-02-04,West Ham,Sunderland,2,0,H,2006-02-04,5,0,2,2,3,-2,3,0,3
242,2006-02-05,Chelsea,Liverpool,2,0,H,2006-02-11,2,1,3,3,-1,-2,3,3,0
243,2006-02-05,Tottenham,Charlton,3,1,H,2006-02-11,3,3,1,1,2,2,3,0,3
244,2006-02-08,Charlton,Liverpool,2,0,H,2006-02-11,3,1,3,3,0,-2,3,3,0
245,2006-02-11,Arsenal,Bolton,1,1,D,2006-02-11,1,1,1,1,0,0,1,1,0
246,2006-02-11,Aston Villa,Newcastle,1,2,A,2006-02-11,1,2,2,2,-1,0,0,3,-3
247,2006-02-11,Everton,Blackburn,1,0,H,2006-02-11,1,0,0,0,1,0,3,0,3
248,2006-02-11,Fulham,West Brom,6,1,H,2006-02-11,6,1,1,1,5,0,3,0,3
249,2006-02-11,Middlesbrough,Chelsea,3,0,H,2006-02-11,3,2,0,0,3,2,3,0,3
250,2006-02-11,Portsmouth,Man United,1,3,A,2006-02-11,1,3,3,3,-2,0,0,3,-3
251,2006-02-11,Wigan,Liverpool,0,1,A,2006-02-11,0,1,1,1,-1,0,0,3,-3
252,2006-02-12,Man City,Charlton,3,2,H,2006-02-18,3,2,2,2,1,0,3,0,3
253,2006-02-12,Sunderland,Tottenham,1,1,D,2006-02-18,1,1,3,3,-2,-2,1,1,0
254,2006-02-13,West Ham,Birmingham,3,0,H,2006-02-18,3,0,0,0,3,0,3,0,3
255,2006-02-14,Liverpool,Arsenal,1,0,H,2006-02-18,1,0,0,0,1,0,3,0,3
256,2006-02-15,Blackburn,Sunderland,2,0,H,2006-02-18,2,1,0,0,2,1,3,0,3
257,2006-02-19,Tottenham,Wigan,2,2,D,2006-02-25,2,2,2,2,0,0,1,1,0
258,2006-02-22,Newcastle,Charlton,0,0,D,2006-02-25,2,0,0,0,2,0,4,1,3
259,2006-02-25,Birmingham,Sunderland,1,0,H,2006-02-25,1,0,0,0,1,0,3,0,3
260,2006-02-25,Blackburn,Arsenal,1,0,H,2006-02-25,1,0,0,0,1,0,3,0,3
261,2006-02-25,Charlton,Aston Villa,0,0,D,2006-02-25,0,0,0,0,0,0,1,1,0
262,2006-02-25,Chelsea,Portsmouth,2,0,H,2006-02-25,2,0,0,0,2,0,3,0,3
263,2006-02-25,Newcastle,Everton,2,0,H,2006-02-25,2,0,0,0,2,0,4,0,4
264,2006-02-26,Bolton,Fulham,2,1,H,2006-03-04,3,1,4,4,-1,-3,3,0,3
265,2006-02-26,Liverpool,Man City,1,0,H,2006-03-04,1,0,0,0,1,0,4,0,4
266,2006-02-26,West Brom,Middlesbrough,0,2,A,2006-03-04,1,3,4,4,-3,-1,0,3,-3
267,2006-03-04,Aston Villa,Portsmouth,1,0,H,2006-03-04,1,0,0,0,1,0,3,0,3
268,2006-03-04,Fulham,Arsenal,0,4,A,2006-03-04,1,4,6,6,-5,-2,0,3,-3
269,2006-03-04,Liverpool,Charlton,0,0,D,2006-03-04,1,0,0,0,1,0,4,1,3
270,2006-03-04,Middlesbrough,Birmingham,1,0,H,2006-03-04,3,0,0,0,3,0,3,0,3
271,2006-03-04,Newcastle,Bolton,3,1,H,2006-03-04,3,3,1,1,2,2,3,0,3
272,2006-03-04,West Brom,Chelsea,1,2,A,2006-03-04,1,2,4,4,-3,-2,0,3,-3
273,2006-03-04,West Ham,Everton,2,2,D,2006-03-04,2,2,2,2,0,0,1,1,0
274,2006-03-05,Man City,Sunderland,2,1,H,2006-03-11,3,1,3,3,0,-2,3,0,3
275,2006-03-05,Tottenham,Blackburn,3,2,H,2006-03-11,4,4,4,4,0,0,3,0,3
276,2006-03-06,Wigan,Man United,1,2,A,2006-03-11,2,2,2,2,0,0,0,3,-3
277,2006-03-11,Birmingham,West Brom,1,1,D,2006-03-11,1,1,1,1,0,0,1,1,0
278,2006-03-11,Blackburn,Aston Villa,2,0,H,2006-03-11,4,0,3,3,1,-3,3,0,3
279,2006-03-11,Bolton,West Ham,4,1,H,2006-03-11,4,1,1,1,3,0,3,0,3
280,2006-03-11,Chelsea,Tottenham,2,1,H,2006-03-11,2,4,1,1,1,3,3,0,3
281,2006-03-11,Everton,Fulham,3,1,H,2006-03-11,3,1,1,1,2,0,3,0,3
282,2006-03-11,Portsmouth,Man City,2,1,H,2006-03-11,2,3,1,1,1,2,3,0,3
283,2006-03-11,Sunderland,Wigan,0,1,A,2006-03-11,1,2,3,3,-2,-1,0,3,-3
284,2006-03-12,Arsenal,Liverpool,2,1,H,2006-03-18,5,6,1,1,4,5,6,0,6
285,2006-03-12,Charlton,Middlesbrough,2,1,H,2006-03-18,2,3,4,4,-2,-1,3,0,3
286,2006-03-12,Man United,Newcastle,2,0,H,2006-03-18,4,0,1,1,3,-1,3,0,3
287,2006-03-15,Liverpool,Fulham,5,1,H,2006-03-18,6,1,3,3,3,-2,3,0,3
288,2006-03-18,Arsenal,Charlton,3,0,H,2006-03-18,5,2,1,1,4,1,6,0,6
289,2006-03-18,Birmingham,Tottenham,0,2,A,2006-03-18,0,2,2,2,-2,0,0,3,-3
290,2006-03-18,Blackburn,Middlesbrough,3,2,H,2006-03-18,3,3,2,2,1,1,3,0,3
291,2006-03-18,Bolton,Sunderland,2,0,H,2006-03-18,2,0,0,0,2,0,3,0,3
292,2006-03-18,Everton,Aston Villa,4,1,H,2006-03-18,4,1,1,1,3,0,3,0,3
293,2006-03-18,Man City,Wigan,0,1,A,2006-03-18,0,1,1,1,-1,0,0,3,-3
294,2006-03-18,West Brom,Man United,1,2,A,2006-03-18,1,4,2,2,-1,2,0,3,-3
295,2006-03-18,West Ham,Portsmouth,2,4,A,2006-03-18,2,4,4,4,-2,0,0,3,-3
296,2006-03-19,Fulham,Chelsea,1,0,H,2006-03-25,1,2,0,0,1,2,3,0,3
297,2006-03-19,Newcastle,Liverpool,1,3,A,2006-03-25,1,6,3,3,-2,3,0,3,-3
298,2006-03-25,Aston Villa,Fulham,0,0,D,2006-03-25,0,1,0,0,0,1,1,1,0
299,2006-03-25,Chelsea,Man City,2,0,H,2006-03-25,2,0,1,1,1,-1,3,0,3
300,2006-03-25,Liverpool,Everton,3,1,H,2006-03-25,6,1,2,2,4,-1,3,0,3
301,2006-03-25,Sunderland,Blackburn,0,1,A,2006-03-25,0,1,1,1,-1,0,0,3,-3
302,2006-03-25,Wigan,West Ham,1,2,A,2006-03-25,1,2,2,2,-1,0,0,3,-3
303,2006-03-26,Charlton,Newcastle,3,1,H,2006-04-01,3,4,1,1,2,3,3,0,3
304,2006-03-26,Man United,Birmingham,3,0,H,2006-04-01,6,0,1,1,5,-1,6,0,6
305,2006-03-26,Middlesbrough,Bolton,4,3,H,2006-04-01,4,4,3,3,1,1,3,0,3
306,2006-03-27,Tottenham,West Brom,2,1,H,2006-04-01,3,1,4,4,-1,-3,3,0,3
307,2006-03-29,Man United,West Ham,1,0,H,2006-04-01,6,0,1,1,5,-1,6,0,6
308,2006-04-01,Arsenal,Aston Villa,5,0,H,2006-04-01,5,0,0,0,5,0,3,0,3
309,2006-04-01,Birmingham,Chelsea,0,0,D,2006-04-01,0,0,3,3,-3,-3,1,1,0
310,2006-04-01,Bolton,Man United,1,2,A,2006-04-01,4,6,6,6,-2,0,0,3,-3
311,2006-04-01,Everton,Sunderland,2,2,D,2006-04-01,2,2,2,2,0,0,1,1,0
312,2006-04-01,Fulham,Portsmouth,1,3,A,2006-04-01,1,3,3,3,-2,0,0,3,-3
313,2006-04-01,Newcastle,Tottenham,3,1,H,2006-04-01,4,3,4,4,0,-1,3,0,3
314,2006-04-01,West Brom,Liverpool,0,2,A,2006-04-01,1,2,4,4,-3,-2,0,3,-3
315,2006-04-02,Man City,Middlesbrough,0,1,A,2006-04-08,1,1,3,3,-2,-2,0,3,-3
316,2006-04-02,West Ham,Charlton,0,0,D,2006-04-08,0,0,0,0,0,0,1,1,0
317,2006-04-03,Blackburn,Wigan,1,1,D,2006-04-08,3,2,3,3,0,-1,1,1,0
318,2006-04-04,Birmingham,Bolton,1,0,H,2006-04-08,2,0,1,1,1,-1,3,0,3
319,2006-04-08,Charlton,Everton,0,0,D,2006-04-08,0,0,0,0,0,0,1,1,0
320,2006-04-08,Portsmouth,Blackburn,2,2,D,2006-04-08,2,3,2,2,0,1,1,1,0
321,2006-04-08,Tottenham,Man City,2,1,H,2006-04-08,2,1,1,1,1,0,3,0,3
322,2006-04-08,Wigan,Birmingham,1,1,D,2006-04-08,2,2,2,2,0,0,1,1,0
323,2006-04-09,Aston Villa,West Brom,0,0,D,2006-04-15,0,1,0,0,0,1,1,1,0
324,2006-04-09,Chelsea,West Ham,4,1,H,2006-04-15,6,2,1,1,5,1,3,0,3
325,2006-04-09,Liverpool,Bolton,1,0,H,2006-04-15,1,0,0,0,1,0,3,0,3
326,2006-04-09,Man United,Arsenal,2,0,H,2006-04-15,2,4,0,0,2,4,4,1,3
327,2006-04-09,Middlesbrough,Newcastle,1,2,A,2006-04-15,1,5,3,3,-2,2,0,3,-3
328,2006-04-12,Portsmouth,Arsenal,1,1,D,2006-04-15,2,4,1,1,1,3,4,1,3
329,2006-04-14,Man United,Sunderland,0,0,D,2006-04-15,2,0,0,0,2,0,4,1,3
330,2006-04-15,Arsenal,West Brom,3,1,H,2006-04-15,4,1,4,4,0,-3,3,1,2
331,2006-04-15,Bolton,Chelsea,0,2,A,2006-04-15,0,6,3,3,-3,3,0,3,-3
332,2006-04-15,Everton,Tottenham,0,1,A,2006-04-15,0,1,1,1,-1,0,0,3,-3
333,2006-04-15,Fulham,Charlton,2,1,H,2006-04-15,2,1,1,1,1,0,3,0,3
334,2006-04-15,Newcastle,Wigan,3,1,H,2006-04-15,5,1,2,2,3,-1,3,0,3
335,2006-04-15,Portsmouth,Middlesbrough,1,0,H,2006-04-15,2,1,1,1,1,0,4,0,4
336,2006-04-15,West Ham,Man City,1,0,H,2006-04-15,2,0,4,4,-2,-4,3,0,3
337,2006-04-16,Aston Villa,Birmingham,3,1,H,2006-04-22,5,3,4,4,1,-1,3,1,2
338,2006-04-16,Blackburn,Liverpool,0,1,A,2006-04-22,1,1,3,3,-2,-2,0,3,-3
339,2006-04-17,Charlton,Portsmouth,2,1,H,2006-04-22,3,3,5,5,-2,-2,3,0,3
340,2006-04-17,Chelsea,Everton,3,0,H,2006-04-22,3,0,0,0,3,0,3,0,3
341,2006-04-17,Middlesbrough,West Ham,2,0,H,2006-04-22,2,0,0,0,2,0,3,0,3
342,2006-04-17,Sunderland,Newcastle,1,4,A,2006-04-22,2,7,6,6,-4,1,0,3,-3
343,2006-04-17,Tottenham,Man United,1,2,A,2006-04-22,2,2,3,3,-1,-1,0,3,-3
344,2006-04-17,West Brom,Bolton,0,0,D,2006-04-22,0,4,3,3,-3,1,1,1,0
345,2006-04-18,Wigan,Aston Villa,3,2,H,2006-04-22,3,5,2,2,1,3,3,0,3
346,2006-04-19,Birmingham,Blackburn,2,1,H,2006-04-22,3,1,4,4,-1,-3,3,0,3
347,2006-04-22,Arsenal,Tottenham,1,1,D,2006-04-22,1,2,1,1,0,1,1,1,0
348,2006-04-22,Bolton,Charlton,4,1,H,2006-04-22,4,3,1,1,3,2,3,0,3
349,2006-04-22,Everton,Birmingham,0,0,D,2006-04-22,0,3,3,3,-3,0,1,1,0
350,2006-04-22,Newcastle,West Brom,3,0,H,2006-04-22,7,0,1,1,6,-1,3,0,3
351,2006-04-22,Portsmouth,Sunderland,2,1,H,2006-04-22,3,2,3,3,0,-1,3,0,3
352,2006-04-24,Fulham,Wigan,1,0,H,2006-04-29,3,1,1,1,2,0,3,0,3
353,2006-04-25,Aston Villa,Man City,0,1,A,2006-04-29,1,2,4,4,-3,-2,0,3,-3
354,2006-04-26,West Ham,Liverpool,1,2,A,2006-04-29,1,5,2,2,-1,3,0,3,-3
355,2006-04-29,Birmingham,Newcastle,0,0,D,2006-04-29,0,0,0,0,0,0,1,1,0
356,2006-04-29,Charlton,Blackburn,0,2,A,2006-04-29,0,2,2,2,-2,0,0,3,-3
357,2006-04-29,Chelsea,Man United,3,0,H,2006-04-29,3,0,0,0,3,0,3,0,3
358,2006-04-29,Liverpool,Aston Villa,3,1,H,2006-04-29,5,1,2,2,3,-1,3,0,3
359,2006-04-29,Man City,Fulham,1,2,A,2006-04-29,2,3,2,2,0,1,0,3,-3
360,2006-04-29,Middlesbrough,Everton,0,1,A,2006-04-29,0,1,1,1,-1,0,0,3,-3
361,2006-04-29,Wigan,Portsmouth,1,2,A,2006-04-29,1,2,3,3,-2,-1,0,3,-3
362,2006-04-30,Tottenham,Bolton,1,0,H,2006-05-06,1,1,0,0,1,1,3,0,3
363,2006-05-01,Man United,Middlesbrough,0,0,D,2006-05-06,0,1,0,0,0,1,1,2,-1
364,2006-05-01,Sunderland,Arsenal,0,3,A,2006-05-06,2,6,4,4,-2,2,3,6,-3
365,2006-05-01,West Brom,West Ham,0,1,A,2006-05-06,0,1,1,1,-1,0,0,3,-3
366,2006-05-02,Blackburn,Chelsea,1,0,H,2006-05-06,1,0,0,0,1,0,3,0,3
367,2006-05-03,Bolton,Middlesbrough,1,1,D,2006-05-06,1,1,2,2,-1,-1,1,2,-1
368,2006-05-04,Man City,Arsenal,1,3,A,2006-05-06,1,6,3,3,-2,3,0,6,-6
369,2006-05-04,Sunderland,Fulham,2,1,H,2006-05-06,2,1,4,4,-2,-3,3,0,3
370,2006-05-07,Arsenal,Wigan,4,2,H,2006-05-13,4,2,2,2,2,0,3,0,3
371,2006-05-07,Aston Villa,Sunderland,2,1,H,2006-05-13,2,1,1,1,1,0,3,0,3
372,2006-05-07,Blackburn,Man City,2,0,H,2006-05-13,2,0,0,0,2,0,3,0,3
373,2006-05-07,Bolton,Birmingham,1,0,H,2006-05-13,1,0,0,0,1,0,3,0,3
374,2006-05-07,Everton,West Brom,2,2,D,2006-05-13,2,2,2,2,0,0,1,1,0
375,2006-05-07,Fulham,Middlesbrough,1,0,H,2006-05-13,1,0,0,0,1,0,3,0,3
376,2006-05-07,Man United,Charlton,4,0,H,2006-05-13,4,0,0,0,4,0,3,0,3
377,2006-05-07,Newcastle,Chelsea,1,0,H,2006-05-13,1,0,0,0,1,0,3,0,3
378,2006-05-07,Portsmouth,Liverpool,1,3,A,2006-05-13,1,3,3,3,-2,0,0,3,-3
379,2006-05-07,West Ham,Tottenham,2,1,H,2006-05-13,2,1,1,1,1,0,3,0,3
380,2006-08-19,Arsenal,Aston Villa,1,1,D,2006-08-19,1,1,1,1,0,0,1,1,0
381,2006-08-19,Bolton,Tottenham,2,0,H,2006-08-19,2,0,0,0,2,0,3,0,3
382,2006-08-19,Everton,Watford,2,1,H,2006-08-19,2,1,1,1,1,0,3,0,3
383,2006-08-19,Newcastle,Wigan,2,1,H,2006-08-19,2,1,1,1,1,0,3,0,3
384,2006-08-19,Portsmouth,Blackburn,3,0,H,2006-08-19,3,0,0,0,3,0,3,0,3
385,2006-08-19,Reading,Middlesbrough,3,2,H,2006-08-19,3,2,2,2,1,0,3,0,3
386,2006-08-19,Sheffield United,Liverpool,1,1,D,2006-08-19,1,1,1,1,0,0,1,1,0
387,2006-08-19,West Ham,Charlton,3,1,H,2006-08-19,3,1,1,1,2,0,3,0,3
388,2006-08-20,Chelsea,Man City,3,0,H,2006-08-26,4,1,2,2,2,-1,3,0,3
389,2006-08-20,Man United,Fulham,5,1,H,2006-08-26,10,3,2,2,8,1,3,0,3
390,2006-08-22,Tottenham,Sheffield United,2,0,H,2006-08-26,2,0,2,2,0,-2,3,0,3
391,2006-08-22,Watford,West Ham,1,1,D,2006-08-26,2,2,3,3,-1,-1,1,1,0
392,2006-08-23,Aston Villa,Reading,2,1,H,2006-08-26,2,1,1,1,1,0,3,0,3
393,2006-08-23,Blackburn,Everton,1,1,D,2006-08-26,1,3,1,1,0,2,1,4,-3
394,2006-08-23,Charlton,Man United,0,3,A,2006-08-26,2,10,3,3,-1,7,3,6,-3
395,2006-08-23,Fulham,Bolton,1,1,D,2006-08-26,3,1,6,6,-3,-5,4,1,3
396,2006-08-23,Man City,Portsmouth,0,0,D,2006-08-26,1,0,3,3,-2,-3,4,1,3
397,2006-08-23,Middlesbrough,Chelsea,2,1,H,2006-08-26,2,4,1,1,1,3,3,0,3
398,2006-08-26,Charlton,Bolton,2,0,H,2006-08-26,2,1,3,3,-1,-2,3,1,2
399,2006-08-26,Fulham,Sheffield United,1,0,H,2006-08-26,3,0,6,6,-3,-6,4,0,4
400,2006-08-26,Liverpool,West Ham,2,1,H,2006-08-26,2,2,1,1,1,1,3,1,2
401,2006-08-26,Man City,Arsenal,1,0,H,2006-08-26,1,0,3,3,-2,-3,4,0,4
402,2006-08-26,Tottenham,Everton,0,2,A,2006-08-26,2,3,2,2,0,1,3,4,-1
403,2006-08-26,Watford,Man United,1,2,A,2006-08-26,2,10,3,3,-1,7,1,6,-5
404,2006-08-26,Wigan,Reading,1,0,H,2006-08-26,1,1,0,0,1,1,3,0,3
405,2006-08-27,Aston Villa,Newcastle,2,0,H,2006-09-02,2,0,0,0,2,0,3,0,3
406,2006-08-27,Blackburn,Chelsea,0,2,A,2006-09-02,0,2,2,2,-2,0,0,3,-3
407,2006-08-28,Middlesbrough,Portsmouth,0,4,A,2006-09-02,0,4,4,4,-4,0,0,3,-3
408,2006-09-09,Arsenal,Middlesbrough,1,1,D,2006-09-09,1,1,1,1,0,0,1,1,0
409,2006-09-09,Bolton,Watford,1,0,H,2006-09-09,1,0,0,0,1,0,3,0,3
410,2006-09-09,Chelsea,Charlton,2,1,H,2006-09-09,2,1,1,1,1,0,3,0,3
411,2006-09-09,Everton,Liverpool,3,0,H,2006-09-09,3,0,0,0,3,0,3,0,3
412,2006-09-09,Man United,Tottenham,1,0,H,2006-09-09,1,0,0,0,1,0,3,0,3
413,2006-09-09,Newcastle,Fulham,1,2,A,2006-09-09,1,2,2,2,-1,0,0,3,-3
414,2006-09-09,Portsmouth,Wigan,1,0,H,2006-09-09,1,0,0,0,1,0,3,0,3
415,2006-09-09,Sheffield United,Blackburn,0,0,D,2006-09-09,0,0,0,0,0,0,1,1,0
416,2006-09-10,West Ham,Aston Villa,1,1,D,2006-09-16,1,1,1,1,0,0,1,2,-1
417,2006-09-11,Reading,Man City,1,0,H,2006-09-16,3,0,1,1,2,-1,3,0,3
418,2006-09-16,Bolton,Middlesbrough,0,0,D,2006-09-16,0,0,0,0,0,0,1,1,0
419,2006-09-16,Charlton,Portsmouth,0,1,A,2006-09-16,0,1,1,1,-1,0,0,3,-3
420,2006-09-16,Everton,Wigan,2,2,D,2006-09-16,2,2,2,2,0,0,1,1,0
421,2006-09-16,Sheffield United,Reading,1,2,A,2006-09-16,1,3,2,2,-1,1,0,3,-3
422,2006-09-16,Watford,Aston Villa,0,0,D,2006-09-16,0,1,0,0,0,1,1,2,-1
423,2006-09-17,Blackburn,Man City,4,2,H,2006-09-23,5,4,2,2,3,2,3,0,3
424,2006-09-17,Chelsea,Liverpool,1,0,H,2006-09-23,3,5,0,0,3,5,3,0,3
425,2006-09-17,Man United,Arsenal,0,1,A,2006-09-23,1,4,2,2,-1,2,0,3,-3
426,2006-09-17,Tottenham,Fulham,0,0,D,2006-09-23,0,0,3,3,-3,-3,1,1,0
427,2006-09-17,West Ham,Newcastle,0,2,A,2006-09-23,0,2,4,4,-4,-2,0,3,-3
428,2006-09-20,Liverpool,Newcastle,2,0,H,2006-09-23,5,2,1,1,4,1,6,3,3
429,2006-09-23,Arsenal,Sheffield United,3,0,H,2006-09-23,4,0,0,0,4,0,3,0,3
430,2006-09-23,Aston Villa,Charlton,2,0,H,2006-09-23,2,0,0,0,2,0,3,0,3
431,2006-09-23,Fulham,Chelsea,0,2,A,2006-09-23,0,3,2,2,-2,1,0,3,-3
432,2006-09-23,Liverpool,Tottenham,3,0,H,2006-09-23,5,0,1,1,4,-1,6,0,6
433,2006-09-23,Man City,West Ham,2,0,H,2006-09-23,4,0,4,4,0,-4,3,0,3
434,2006-09-23,Middlesbrough,Blackburn,0,1,A,2006-09-23,0,5,1,1,-1,4,0,3,-3
435,2006-09-23,Reading,Man United,1,1,D,2006-09-23,1,1,1,1,0,0,1,1,0
436,2006-09-23,Wigan,Watford,1,1,D,2006-09-23,1,1,1,1,0,0,1,1,0
437,2006-09-24,Newcastle,Everton,1,1,D,2006-09-30,1,2,1,1,0,1,1,1,0
438,2006-09-25,Portsmouth,Bolton,0,1,A,2006-09-30,0,3,1,1,-1,2,0,3,-3
439,2006-09-30,Bolton,Liverpool,2,0,H,2006-09-30,3,0,0,0,3,0,3,0,3
440,2006-09-30,Charlton,Arsenal,1,2,A,2006-09-30,1,2,2,2,-1,0,0,3,-3
441,2006-09-30,Chelsea,Aston Villa,1,1,D,2006-09-30,1,1,1,1,0,0,1,1,0
442,2006-09-30,Everton,Man City,1,1,D,2006-09-30,2,1,2,2,0,-1,1,1,0
443,2006-09-30,Sheffield United,Middlesbrough,2,1,H,2006-09-30,2,1,1,1,1,0,3,0,3
444,2006-10-01,Blackburn,Wigan,2,1,H,2006-10-07,2,1,1,1,1,0,3,0,3
445,2006-10-01,Man United,Newcastle,2,0,H,2006-10-07,2,0,0,0,2,0,3,0,3
446,2006-10-01,Tottenham,Portsmouth,2,1,H,2006-10-07,2,1,1,1,1,0,3,0,3
447,2006-10-01,West Ham,Reading,0,1,A,2006-10-07,0,1,1,1,-1,0,0,3,-3
448,2006-10-02,Watford,Fulham,3,3,D,2006-10-07,3,3,3,3,0,0,1,1,0
449,2006-10-14,Arsenal,Watford,3,0,H,2006-10-14,3,0,0,0,3,0,3,0,3
450,2006-10-14,Aston Villa,Tottenham,1,1,D,2006-10-14,1,1,1,1,0,0,1,1,0
451,2006-10-14,Liverpool,Blackburn,1,1,D,2006-10-14,1,1,1,1,0,0,1,1,0
452,2006-10-14,Man City,Sheffield United,0,0,D,2006-10-14,0,0,0,0,0,0,1,1,0
453,2006-10-14,Middlesbrough,Everton,2,1,H,2006-10-14,2,1,1,1,1,0,3,0,3
454,2006-10-14,Portsmouth,West Ham,2,0,H,2006-10-14,2,0,0,0,2,0,3,0,3
455,2006-10-14,Reading,Chelsea,0,1,A,2006-10-14,0,1,1,1,-1,0,0,3,-3
456,2006-10-14,Wigan,Man United,1,3,A,2006-10-14,1,3,3,3,-2,0,0,3,-3
457,2006-10-15,Newcastle,Bolton,1,2,A,2006-10-21,1,2,2,2,-1,0,0,3,-3
458,2006-10-16,Fulham,Charlton,2,1,H,2006-10-21,3,1,2,2,1,-1,3,0,3
459,2006-10-21,Aston Villa,Fulham,1,1,D,2006-10-21,1,3,1,1,0,2,1,1,0
460,2006-10-21,Charlton,Watford,0,0,D,2006-10-21,1,0,2,2,-1,-2,1,1,0
461,2006-10-21,Chelsea,Portsmouth,2,1,H,2006-10-21,2,1,1,1,1,0,3,0,3
462,2006-10-21,Everton,Sheffield United,2,0,H,2006-10-21,2,0,0,0,2,0,3,0,3
463,2006-10-21,Wigan,Man City,4,0,H,2006-10-21,4,0,0,0,4,0,3,0,3
464,2006-10-22,Blackburn,Bolton,0,1,A,2006-10-28,0,1,1,1,-1,0,0,3,-3
465,2006-10-22,Man United,Liverpool,2,0,H,2006-10-28,6,3,0,0,6,3,3,0,3
466,2006-10-22,Middlesbrough,Newcastle,1,0,H,2006-10-28,1,0,0,0,1,0,3,0,3
467,2006-10-22,Reading,Arsenal,0,4,A,2006-10-28,1,5,7,7,-6,-2,0,3,-3
468,2006-10-22,Tottenham,West Ham,1,0,H,2006-10-28,1,0,0,0,1,0,3,0,3
469,2006-10-28,Arsenal,Everton,1,1,D,2006-10-28,5,1,1,1,4,0,1,1,0
470,2006-10-28,Bolton,Man United,0,4,A,2006-10-28,1,6,4,4,-3,2,0,3,-3
471,2006-10-28,Fulham,Wigan,0,1,A,2006-10-28,0,1,1,1,-1,0,0,3,-3
472,2006-10-28,Liverpool,Aston Villa,3,1,H,2006-10-28,3,1,3,3,0,-2,3,0,3
473,2006-10-28,Newcastle,Charlton,0,0,D,2006-10-28,0,0,1,1,-1,-1,1,1,0
474,2006-10-28,Portsmouth,Reading,3,1,H,2006-10-28,3,1,1,1,2,0,3,0,3
475,2006-10-28,Sheffield United,Chelsea,0,2,A,2006-10-28,0,2,2,2,-2,0,0,3,-3
476,2006-10-28,Watford,Tottenham,0,0,D,2006-10-28,0,1,0,0,0,1,1,1,0
477,2006-10-29,West Ham,Blackburn,2,1,H,2006-11-04,2,1,1,1,1,0,3,0,3
478,2006-10-30,Man City,Middlesbrough,1,0,H,2006-11-04,1,0,1,1,0,-1,3,0,3
479,2006-11-04,Bolton,Wigan,0,1,A,2006-11-04,0,1,1,1,-1,0,0,3,-3
480,2006-11-04,Charlton,Man City,1,0,H,2006-11-04,1,1,0,0,1,1,3,0,3
481,2006-11-04,Fulham,Everton,1,0,H,2006-11-04,1,0,0,0,1,0,3,0,3
482,2006-11-04,Liverpool,Reading,2,0,H,2006-11-04,2,0,0,0,2,0,3,0,3
483,2006-11-04,Man United,Portsmouth,3,0,H,2006-11-04,3,0,0,0,3,0,3,0,3
484,2006-11-04,Newcastle,Sheffield United,0,1,A,2006-11-04,0,1,1,1,-1,0,0,3,-3
485,2006-11-04,Watford,Middlesbrough,2,0,H,2006-11-04,2,0,0,0,2,0,3,0,3
486,2006-11-05,Aston Villa,Blackburn,2,0,H,2006-11-11,3,0,0,0,3,0,3,0,3
487,2006-11-05,Tottenham,Chelsea,2,1,H,2006-11-11,2,5,1,1,1,4,3,0,3
488,2006-11-05,West Ham,Arsenal,1,0,H,2006-11-11,1,0,1,1,0,-1,3,0,3
489,2006-11-11,Blackburn,Man United,0,1,A,2006-11-11,0,1,3,3,-3,-2,0,3,-3
490,2006-11-11,Chelsea,Watford,4,0,H,2006-11-11,5,0,2,2,3,-2,3,0,3
491,2006-11-11,Everton,Aston Villa,0,1,A,2006-11-11,0,3,1,1,-1,2,0,3,-3
492,2006-11-11,Man City,Newcastle,0,0,D,2006-11-11,0,0,0,0,0,0,1,1,0
493,2006-11-11,Middlesbrough,West Ham,1,0,H,2006-11-11,1,1,0,0,1,1,3,0,3
494,2006-11-11,Portsmouth,Fulham,1,1,D,2006-11-11,1,1,1,1,0,0,1,1,0
495,2006-11-11,Sheffield United,Bolton,2,2,D,2006-11-11,2,2,2,2,0,0,1,1,0
496,2006-11-11,Wigan,Charlton,3,2,H,2006-11-11,3,2,2,2,1,0,3,0,3
497,2006-11-12,Arsenal,Liverpool,3,0,H,2006-11-18,4,0,1,1,3,-1,4,1,3
498,2006-11-12,Reading,Tottenham,3,1,H,2006-11-18,5,1,1,1,4,0,6,0,6
499,2006-11-18,Arsenal,Newcastle,1,1,D,2006-11-18,4,1,1,1,3,0,4,1,3
500,2006-11-18,Chelsea,West Ham,1,0,H,2006-11-18,1,0,0,0,1,0,3,0,3
501,2006-11-18,Everton,Bolton,1,0,H,2006-11-18,1,0,0,0,1,0,3,0,3
502,2006-11-18,Man City,Fulham,3,1,H,2006-11-18,3,1,1,1,2,0,3,0,3
503,2006-11-18,Middlesbrough,Liverpool,0,0,D,2006-11-18,0,0,0,0,0,0,1,1,0
504,2006-11-18,Portsmouth,Watford,2,1,H,2006-11-18,2,1,1,1,1,0,3,0,3
505,2006-11-18,Reading,Charlton,2,0,H,2006-11-18,5,0,1,1,4,-1,6,0,6
506,2006-11-18,Sheffield United,Man United,1,2,A,2006-11-18,1,2,2,2,-1,0,0,3,-3
507,2006-11-19,Blackburn,Tottenham,1,1,D,2006-11-25,1,1,1,1,0,0,1,1,0
508,2006-11-19,Wigan,Aston Villa,0,0,D,2006-11-25,0,1,0,0,0,1,1,1,0
509,2006-11-25,Aston Villa,Middlesbrough,1,1,D,2006-11-25,1,1,1,1,0,0,1,1,0
510,2006-11-25,Bolton,Arsenal,3,1,H,2006-11-25,3,1,1,1,2,0,3,0,3
511,2006-11-25,Charlton,Everton,1,1,D,2006-11-25,1,1,1,1,0,0,1,1,0
512,2006-11-25,Fulham,Reading,0,1,A,2006-11-25,0,1,1,1,-1,0,0,3,-3
513,2006-11-25,Liverpool,Man City,1,0,H,2006-11-25,1,0,0,0,1,0,3,0,3
514,2006-11-25,West Ham,Sheffield United,1,0,H,2006-11-25,1,0,0,0,1,0,3,0,3
515,2006-11-26,Man United,Chelsea,1,1,D,2006-12-02,6,2,2,2,4,0,4,4,0
516,2006-11-26,Newcastle,Portsmouth,1,0,H,2006-12-02,1,2,0,0,1,2,3,1,2
517,2006-11-26,Tottenham,Wigan,3,1,H,2006-12-02,3,1,4,4,-1,-3,3,0,3
518,2006-11-28,Watford,Sheffield United,0,1,A,2006-12-02,0,3,1,1,-1,2,0,3,-3
519,2006-11-29,Aston Villa,Man City,1,3,A,2006-12-02,3,3,5,5,-2,-2,0,3,-3
520,2006-11-29,Bolton,Chelsea,0,1,A,2006-12-02,0,2,2,2,-2,0,0,4,-4
521,2006-11-29,Fulham,Arsenal,2,1,H,2006-12-02,2,4,3,3,-1,1,3,0,3
522,2006-11-29,Liverpool,Portsmouth,0,0,D,2006-12-02,4,2,0,0,4,2,1,1,0
523,2006-11-29,Man United,Everton,3,0,H,2006-12-02,6,0,2,2,4,-2,4,0,4
524,2006-12-02,Arsenal,Tottenham,3,0,H,2006-12-02,4,3,2,2,2,1,3,0,3
525,2006-12-02,Blackburn,Fulham,2,0,H,2006-12-02,2,2,0,0,2,2,3,0,3
526,2006-12-02,Middlesbrough,Man United,1,2,A,2006-12-02,1,6,2,2,-1,4,0,3,-3
527,2006-12-02,Portsmouth,Aston Villa,2,2,D,2006-12-02,2,3,3,3,-1,0,1,1,0
528,2006-12-02,Reading,Bolton,1,0,H,2006-12-02,1,0,0,0,1,0,3,0,3
529,2006-12-02,Sheffield United,Charlton,2,1,H,2006-12-02,3,1,1,1,2,0,3,0,3
530,2006-12-02,Wigan,Liverpool,0,4,A,2006-12-02,1,4,7,7,-6,-3,0,3,-3
531,2006-12-03,Everton,West Ham,2,0,H,2006-12-09,2,0,2,2,0,-2,3,0,3
532,2006-12-04,Man City,Watford,0,0,D,2006-12-09,1,0,3,3,-2,-3,1,1,0
533,2006-12-05,Charlton,Blackburn,1,0,H,2006-12-09,2,1,5,5,-3,-4,3,0,3
534,2006-12-05,Tottenham,Middlesbrough,2,1,H,2006-12-09,7,2,2,2,5,0,6,0,6
535,2006-12-06,Newcastle,Reading,3,2,H,2006-12-09,6,2,3,3,3,-1,3,1,2
536,2006-12-06,West Ham,Wigan,0,2,A,2006-12-09,0,3,8,8,-8,-5,0,4,-4
537,2006-12-09,Blackburn,Newcastle,1,3,A,2006-12-09,1,6,4,4,-3,2,0,3,-3
538,2006-12-09,Bolton,West Ham,4,0,H,2006-12-09,4,0,0,0,4,0,3,0,3
539,2006-12-09,Liverpool,Fulham,4,0,H,2006-12-09,4,0,0,0,4,0,3,0,3
540,2006-12-09,Man United,Man City,3,1,H,2006-12-09,3,1,1,1,2,0,3,0,3
541,2006-12-09,Middlesbrough,Wigan,1,1,D,2006-12-09,2,3,3,3,-1,0,1,4,-3
542,2006-12-09,Portsmouth,Everton,2,0,H,2006-12-09,2,2,0,0,2,2,3,0,3
543,2006-12-09,Tottenham,Charlton,5,1,H,2006-12-09,7,2,2,2,5,0,6,0,6
544,2006-12-09,Watford,Reading,0,0,D,2006-12-09,0,2,0,0,0,2,1,1,0
545,2006-12-10,Chelsea,Arsenal,1,1,D,2006-12-16,2,4,1,1,1,3,4,4,0
546,2006-12-11,Sheffield United,Aston Villa,2,2,D,2006-12-16,3,2,2,2,1,0,1,1,0
547,2006-12-13,Chelsea,Newcastle,1,0,H,2006-12-16,2,2,1,1,1,1,4,0,4
548,2006-12-13,Wigan,Arsenal,0,1,A,2006-12-16,0,4,2,2,-2,2,0,4,-4
549,2006-12-16,Arsenal,Portsmouth,2,2,D,2006-12-16,4,2,3,3,1,-1,1,1,0
550,2006-12-16,Aston Villa,Bolton,0,1,A,2006-12-16,2,1,3,3,-1,-2,0,3,-3
551,2006-12-16,Charlton,Liverpool,0,3,A,2006-12-16,0,3,3,3,-3,0,0,3,-3
552,2006-12-16,Newcastle,Watford,2,1,H,2006-12-16,2,1,2,2,0,-1,3,0,3
553,2006-12-16,Reading,Blackburn,1,2,A,2006-12-16,1,2,2,2,-1,0,0,3,-3
554,2006-12-16,Wigan,Sheffield United,0,1,A,2006-12-16,0,3,2,2,-2,1,0,3,-3
555,2006-12-17,Everton,Chelsea,2,3,A,2006-12-23,4,6,3,3,1,3,0,6,-6
556,2006-12-17,Man City,Tottenham,1,2,A,2006-12-23,1,3,4,4,-3,-1,0,3,-3
557,2006-12-17,West Ham,Man United,1,0,H,2006-12-23,1,3,0,0,1,3,3,3,0
558,2006-12-18,Fulham,Middlesbrough,2,1,H,2006-12-23,2,3,1,1,1,2,4,0,4
559,2006-12-23,Arsenal,Blackburn,6,2,H,2006-12-23,6,2,2,2,4,0,3,0,3
560,2006-12-23,Aston Villa,Man United,0,3,A,2006-12-23,0,3,3,3,-3,0,0,3,-3
561,2006-12-23,Fulham,West Ham,0,0,D,2006-12-23,2,1,1,1,1,0,4,1,3
562,2006-12-23,Liverpool,Watford,2,0,H,2006-12-23,2,0,0,0,2,0,3,0,3
563,2006-12-23,Man City,Bolton,0,2,A,2006-12-23,1,2,4,4,-3,-2,0,3,-3
564,2006-12-23,Middlesbrough,Charlton,2,0,H,2006-12-23,3,0,2,2,1,-2,3,0,3
565,2006-12-23,Newcastle,Tottenham,3,1,H,2006-12-23,3,3,1,1,2,2,3,3,0
566,2006-12-23,Portsmouth,Sheffield United,3,1,H,2006-12-23,3,1,1,1,2,0,3,0,3
567,2006-12-23,Reading,Everton,0,2,A,2006-12-23,0,4,2,2,-2,2,0,3,-3
568,2006-12-23,Wigan,Chelsea,2,3,A,2006-12-23,2,6,3,3,-1,3,0,6,-6
569,2006-12-26,Blackburn,Liverpool,1,0,H,2006-12-30,3,1,1,1,2,0,6,3,3
570,2006-12-26,Bolton,Newcastle,2,1,H,2006-12-30,5,1,3,3,2,-2,6,0,6
571,2006-12-26,Chelsea,Reading,2,2,D,2006-12-30,4,4,4,4,0,0,2,1,1
572,2006-12-26,Everton,Middlesbrough,0,0,D,2006-12-30,3,1,0,0,3,1,4,1,3
573,2006-12-26,Man United,Wigan,3,1,H,2006-12-30,6,1,3,3,3,-2,6,0,6
574,2006-12-26,Sheffield United,Man City,0,1,A,2006-12-30,1,2,1,1,0,1,3,6,-3
575,2006-12-26,Tottenham,Aston Villa,2,1,H,2006-12-30,2,2,2,2,0,0,3,0,3
576,2006-12-26,Watford,Arsenal,1,2,A,2006-12-30,1,2,2,2,-1,0,0,3,-3
577,2006-12-26,West Ham,Portsmouth,1,2,A,2006-12-30,1,4,3,3,-2,1,0,3,-3
578,2006-12-27,Charlton,Fulham,2,2,D,2006-12-30,4,4,3,3,1,1,4,2,2
579,2006-12-30,Blackburn,Middlesbrough,2,1,H,2006-12-30,3,1,1,1,2,0,6,1,5
580,2006-12-30,Bolton,Portsmouth,3,2,H,2006-12-30,5,4,3,3,2,1,6,3,3
581,2006-12-30,Charlton,Aston Villa,2,1,H,2006-12-30,4,2,3,3,1,-1,4,0,4
582,2006-12-30,Chelsea,Fulham,2,2,D,2006-12-30,4,4,4,4,0,0,2,2,0
583,2006-12-30,Everton,Newcastle,3,0,H,2006-12-30,3,1,0,0,3,1,4,0,4
584,2006-12-30,Man United,Reading,3,2,H,2006-12-30,6,4,3,3,3,1,6,1,5
585,2006-12-30,Sheffield United,Arsenal,1,0,H,2006-12-30,1,2,1,1,0,1,3,3,0
586,2006-12-30,Tottenham,Liverpool,0,1,A,2006-12-30,2,1,2,2,0,-1,3,3,0
587,2006-12-30,West Ham,Man City,0,1,A,2006-12-30,1,2,3,3,-2,-1,0,6,-6
588,2007-01-01,Fulham,Watford,0,0,D,2007-01-06,0,0,0,0,0,0,1,1,0
589,2007-01-01,Liverpool,Bolton,3,0,H,2007-01-06,3,0,0,0,3,0,3,0,3
590,2007-01-01,Man City,Everton,2,1,H,2007-01-06,2,1,1,1,1,0,3,0,3
591,2007-01-01,Middlesbrough,Sheffield United,3,1,H,2007-01-06,3,1,1,1,2,0,3,0,3
592,2007-01-01,Newcastle,Man United,2,2,D,2007-01-06,2,2,2,2,0,0,1,1,0
593,2007-01-01,Portsmouth,Tottenham,1,1,D,2007-01-06,1,1,1,1,0,0,1,1,0
594,2007-01-01,Reading,West Ham,6,0,H,2007-01-06,6,0,0,0,6,0,3,0,3
595,2007-01-01,Wigan,Blackburn,0,3,A,2007-01-06,0,3,3,3,-3,0,0,3,-3
596,2007-01-02,Arsenal,Charlton,4,0,H,2007-01-06,4,0,0,0,4,0,3,0,3
597,2007-01-02,Aston Villa,Chelsea,0,0,D,2007-01-06,0,0,0,0,0,0,1,1,0
598,2007-01-13,Blackburn,Arsenal,0,2,A,2007-01-13,0,2,2,2,-2,0,0,3,-3
599,2007-01-13,Bolton,Man City,0,0,D,2007-01-13,0,0,0,0,0,0,1,1,0
600,2007-01-13,Charlton,Middlesbrough,1,3,A,2007-01-13,1,3,3,3,-2,0,0,3,-3
601,2007-01-13,Chelsea,Wigan,4,0,H,2007-01-13,4,0,0,0,4,0,3,0,3
602,2007-01-13,Man United,Aston Villa,3,1,H,2007-01-13,3,1,1,1,2,0,3,0,3
603,2007-01-13,Sheffield United,Portsmouth,1,1,D,2007-01-13,1,1,1,1,0,0,1,1,0
604,2007-01-13,Watford,Liverpool,0,3,A,2007-01-13,0,3,3,3,-3,0,0,3,-3
605,2007-01-13,West Ham,Fulham,3,3,D,2007-01-13,3,3,3,3,0,0,1,1,0
606,2007-01-14,Everton,Reading,1,1,D,2007-01-20,1,4,1,1,0,3,1,1,0
607,2007-01-14,Tottenham,Newcastle,2,3,A,2007-01-20,3,5,4,4,-1,1,0,3,-3
608,2007-01-20,Aston Villa,Watford,2,0,H,2007-01-20,2,0,0,0,2,0,3,0,3
609,2007-01-20,Fulham,Tottenham,1,1,D,2007-01-20,1,3,1,1,0,2,1,1,0
610,2007-01-20,Liverpool,Chelsea,2,0,H,2007-01-20,2,0,0,0,2,0,3,0,3
611,2007-01-20,Man City,Blackburn,0,3,A,2007-01-20,0,3,3,3,-3,0,0,3,-3
612,2007-01-20,Middlesbrough,Bolton,5,1,H,2007-01-20,5,1,1,1,4,0,3,0,3
613,2007-01-20,Newcastle,West Ham,2,2,D,2007-01-20,5,2,4,4,1,-2,1,1,0
614,2007-01-20,Portsmouth,Charlton,0,1,A,2007-01-20,0,1,1,1,-1,0,0,3,-3
615,2007-01-20,Reading,Sheffield United,3,1,H,2007-01-20,4,1,2,2,2,-1,3,0,3
616,2007-01-21,Arsenal,Man United,2,1,H,2007-01-27,2,1,1,1,1,0,3,0,3
617,2007-01-21,Wigan,Everton,0,2,A,2007-01-27,0,2,2,2,-2,0,0,3,-3
618,2007-01-23,Watford,Blackburn,2,1,H,2007-01-27,2,1,1,1,1,0,3,0,3
619,2007-01-30,Portsmouth,Middlesbrough,0,0,D,2007-02-03,0,1,1,1,-1,0,1,1,0
620,2007-01-30,Reading,Wigan,3,2,H,2007-02-03,5,3,2,2,3,1,3,0,3
621,2007-01-30,Sheffield United,Fulham,2,0,H,2007-02-03,3,2,2,2,1,0,3,0,3
622,2007-01-30,West Ham,Liverpool,1,2,A,2007-02-03,1,2,3,3,-2,-1,0,3,-3
623,2007-01-31,Bolton,Charlton,1,1,D,2007-02-03,2,1,1,1,1,0,1,1,0
624,2007-01-31,Chelsea,Blackburn,3,0,H,2007-02-03,4,2,0,0,4,2,3,0,3
625,2007-01-31,Man United,Watford,4,0,H,2007-02-03,4,0,0,0,4,0,3,0,3
626,2007-01-31,Newcastle,Aston Villa,3,1,H,2007-02-03,4,2,3,3,1,-1,3,0,3
627,2007-02-03,Aston Villa,West Ham,1,0,H,2007-02-03,2,1,3,3,-1,-2,3,0,3
628,2007-02-03,Blackburn,Sheffield United,2,1,H,2007-02-03,2,3,4,4,-2,-1,3,0,3
629,2007-02-03,Charlton,Chelsea,0,1,A,2007-02-03,1,4,2,2,-1,2,0,3,-3
630,2007-02-03,Fulham,Newcastle,2,1,H,2007-02-03,2,4,3,3,-1,1,3,0,3
631,2007-02-03,Liverpool,Everton,0,0,D,2007-02-03,2,0,1,1,1,-1,1,1,0
632,2007-02-03,Man City,Reading,0,2,A,2007-02-03,0,5,2,2,-2,3,0,3,-3
633,2007-02-03,Middlesbrough,Arsenal,1,1,D,2007-02-03,1,1,1,1,0,0,1,1,0
634,2007-02-03,Watford,Bolton,0,1,A,2007-02-03,0,2,5,5,-5,-3,0,3,-3
635,2007-02-03,Wigan,Portsmouth,1,0,H,2007-02-03,3,0,3,3,0,-3,3,0,3
636,2007-02-04,Tottenham,Man United,0,4,A,2007-02-10,1,6,6,6,-5,0,0,3,-3
637,2007-02-10,Chelsea,Middlesbrough,3,0,H,2007-02-10,3,0,0,0,3,0,3,0,3
638,2007-02-10,Everton,Blackburn,1,0,H,2007-02-10,1,0,0,0,1,0,3,0,3
639,2007-02-10,Man United,Charlton,2,0,H,2007-02-10,6,0,0,0,6,0,3,0,3
640,2007-02-10,Newcastle,Liverpool,2,1,H,2007-02-10,2,1,1,1,1,0,3,0,3
641,2007-02-10,Portsmouth,Man City,2,1,H,2007-02-10,2,1,1,1,1,0,3,0,3
642,2007-02-10,Reading,Aston Villa,2,0,H,2007-02-10,2,0,0,0,2,0,3,0,3
643,2007-02-10,Sheffield United,Tottenham,2,1,H,2007-02-10,2,1,1,1,1,0,3,0,3
644,2007-02-10,West Ham,Watford,0,1,A,2007-02-10,0,1,1,1,-1,0,0,3,-3
645,2007-02-11,Arsenal,Wigan,2,1,H,2007-02-17,2,1,1,1,1,0,3,0,3
646,2007-02-11,Bolton,Fulham,2,1,H,2007-02-17,2,1,1,1,1,0,3,0,3
647,2007-02-21,Everton,Tottenham,1,2,A,2007-02-24,4,2,2,2,2,0,0,3,-3
648,2007-02-21,Watford,Wigan,1,1,D,2007-02-24,1,1,4,4,-3,-3,1,1,0
649,2007-02-24,Charlton,West Ham,4,0,H,2007-02-24,4,0,0,0,4,0,3,0,3
650,2007-02-24,Fulham,Man United,1,2,A,2007-02-24,1,2,2,2,-1,0,0,3,-3
651,2007-02-24,Liverpool,Sheffield United,4,0,H,2007-02-24,4,0,0,0,4,0,3,0,3
652,2007-02-24,Middlesbrough,Reading,2,1,H,2007-02-24,2,1,1,1,1,0,3,0,3
653,2007-02-24,Watford,Everton,0,3,A,2007-02-24,1,4,4,4,-3,0,1,3,-2
654,2007-02-25,Blackburn,Portsmouth,3,0,H,2007-03-03,3,0,0,0,3,0,3,0,3
655,2007-02-25,Tottenham,Bolton,4,1,H,2007-03-03,4,1,1,1,3,0,3,0,3
656,2007-02-25,Wigan,Newcastle,1,0,H,2007-03-03,2,0,0,0,2,0,3,0,3
657,2007-03-03,Arsenal,Reading,2,1,H,2007-03-03,2,1,1,1,1,0,3,0,3
658,2007-03-03,Fulham,Aston Villa,1,1,D,2007-03-03,1,1,1,1,0,0,1,1,0
659,2007-03-03,Liverpool,Man United,0,1,A,2007-03-03,0,1,1,1,-1,0,0,3,-3
660,2007-03-03,Man City,Wigan,0,1,A,2007-03-03,0,2,1,1,-1,1,0,3,-3
661,2007-03-03,Newcastle,Middlesbrough,0,0,D,2007-03-03,0,0,1,1,-1,-1,1,1,0
662,2007-03-03,Portsmouth,Chelsea,0,2,A,2007-03-03,0,2,5,5,-5,-3,0,3,-3
663,2007-03-03,Sheffield United,Everton,1,1,D,2007-03-03,1,1,1,1,0,0,1,1,0
664,2007-03-03,Watford,Charlton,2,2,D,2007-03-03,2,2,2,2,0,0,1,1,0
665,2007-03-04,Bolton,Blackburn,1,2,A,2007-03-10,1,2,2,2,-1,0,0,3,-3
666,2007-03-04,West Ham,Tottenham,3,4,A,2007-03-10,3,4,4,4,-1,0,0,3,-3
667,2007-03-14,Aston Villa,Arsenal,0,1,A,2007-03-17,0,1,1,1,-1,0,0,3,-3
668,2007-03-14,Man City,Chelsea,0,1,A,2007-03-17,2,4,1,1,1,3,0,3,-3
669,2007-03-17,Blackburn,West Ham,1,2,A,2007-03-17,1,2,2,2,-1,0,0,3,-3
670,2007-03-17,Chelsea,Sheffield United,3,0,H,2007-03-17,4,0,0,0,4,0,3,0,3
671,2007-03-17,Man United,Bolton,4,1,H,2007-03-17,4,1,1,1,3,0,3,0,3
672,2007-03-17,Middlesbrough,Man City,0,2,A,2007-03-17,0,2,2,2,-2,0,0,3,-3
673,2007-03-17,Reading,Portsmouth,0,0,D,2007-03-17,0,0,0,0,0,0,1,1,0
674,2007-03-17,Tottenham,Watford,3,1,H,2007-03-17,3,1,1,1,2,0,3,0,3
675,2007-03-17,Wigan,Fulham,0,0,D,2007-03-17,0,0,0,0,0,0,1,1,0
676,2007-03-18,Aston Villa,Liverpool,0,0,D,2007-03-24,0,0,0,0,0,0,1,1,0
677,2007-03-18,Charlton,Newcastle,2,0,H,2007-03-24,2,0,0,0,2,0,3,0,3
678,2007-03-18,Everton,Arsenal,1,0,H,2007-03-24,1,0,0,0,1,0,3,0,3
679,2007-03-31,Bolton,Sheffield United,1,0,H,2007-03-31,1,0,0,0,1,0,3,0,3
680,2007-03-31,Charlton,Wigan,1,0,H,2007-03-31,1,0,0,0,1,0,3,0,3
681,2007-03-31,Fulham,Portsmouth,1,1,D,2007-03-31,1,1,1,1,0,0,1,1,0
682,2007-03-31,Liverpool,Arsenal,4,1,H,2007-03-31,4,1,1,1,3,0,3,0,3
683,2007-03-31,Man United,Blackburn,4,1,H,2007-03-31,4,1,1,1,3,0,3,0,3
684,2007-03-31,Newcastle,Man City,0,1,A,2007-03-31,0,1,1,1,-1,0,0,3,-3
685,2007-03-31,Watford,Chelsea,0,1,A,2007-03-31,0,1,1,1,-1,0,0,3,-3
686,2007-03-31,West Ham,Middlesbrough,2,0,H,2007-03-31,2,0,0,0,2,0,3,0,3
687,2007-04-01,Tottenham,Reading,1,0,H,2007-04-07,1,1,1,1,0,0,3,0,3
688,2007-04-02,Aston Villa,Everton,1,1,D,2007-04-07,3,5,2,2,1,3,1,1,0
689,2007-04-06,Everton,Fulham,4,1,H,2007-04-07,5,1,2,2,3,-1,3,0,3
690,2007-04-06,Man City,Charlton,0,0,D,2007-04-07,0,0,0,0,0,0,1,1,0
691,2007-04-07,Arsenal,West Ham,0,1,A,2007-04-07,0,1,1,1,-1,0,0,3,-3
692,2007-04-07,Blackburn,Aston Villa,1,2,A,2007-04-07,1,3,2,2,-1,1,0,3,-3
693,2007-04-07,Chelsea,Tottenham,1,0,H,2007-04-07,1,1,0,0,1,1,3,0,3
694,2007-04-07,Middlesbrough,Watford,4,1,H,2007-04-07,4,1,1,1,3,0,3,0,3
695,2007-04-07,Portsmouth,Man United,2,1,H,2007-04-07,2,1,1,1,1,0,3,0,3
696,2007-04-07,Reading,Liverpool,1,2,A,2007-04-07,1,2,3,3,-2,-1,0,3,-3
697,2007-04-07,Sheffield United,Newcastle,1,2,A,2007-04-07,1,2,2,2,-1,0,0,3,-3
698,2007-04-07,Wigan,Bolton,1,3,A,2007-04-07,1,3,3,3,-2,0,0,3,-3
699,2007-04-09,Aston Villa,Wigan,1,1,D,2007-04-14,4,1,2,2,2,-1,1,1,0
700,2007-04-09,Bolton,Everton,1,1,D,2007-04-14,2,1,3,3,-1,-2,1,1,0
701,2007-04-09,Charlton,Reading,0,0,D,2007-04-14,0,1,0,0,0,1,1,1,0
702,2007-04-09,Fulham,Man City,1,3,A,2007-04-14,1,3,4,4,-3,-1,0,3,-3
703,2007-04-09,Newcastle,Arsenal,0,0,D,2007-04-14,1,2,2,2,-1,0,1,1,0
704,2007-04-09,Watford,Portsmouth,4,2,H,2007-04-14,4,4,2,2,2,2,3,0,3
705,2007-04-14,Arsenal,Bolton,2,1,H,2007-04-14,2,2,1,1,1,1,3,0,3
706,2007-04-14,Man City,Liverpool,0,0,D,2007-04-14,3,0,1,1,2,-1,1,1,0
707,2007-04-14,Middlesbrough,Aston Villa,1,3,A,2007-04-14,1,4,3,3,-2,1,0,3,-3
708,2007-04-14,Portsmouth,Newcastle,2,1,H,2007-04-14,4,1,5,5,-1,-4,3,0,3
709,2007-04-14,Reading,Fulham,1,0,H,2007-04-14,1,1,0,0,1,1,3,0,3
710,2007-04-14,Sheffield United,West Ham,3,0,H,2007-04-14,3,0,0,0,3,0,3,0,3
711,2007-04-15,Everton,Charlton,2,1,H,2007-04-21,2,2,2,2,0,0,3,0,3
712,2007-04-15,Wigan,Tottenham,3,3,D,2007-04-21,3,5,5,5,-2,0,1,1,0
713,2007-04-17,Arsenal,Man City,3,1,H,2007-04-21,5,2,3,3,2,-1,3,1,2
714,2007-04-17,Man United,Sheffield United,2,0,H,2007-04-21,3,1,1,1,2,0,4,1,3
715,2007-04-18,Blackburn,Watford,3,1,H,2007-04-21,4,2,2,2,2,0,3,0,3
716,2007-04-18,Liverpool,Middlesbrough,2,0,H,2007-04-21,4,1,0,0,4,1,6,1,5
717,2007-04-18,West Ham,Chelsea,1,4,A,2007-04-21,2,4,4,4,-2,0,3,3,0
718,2007-04-21,Bolton,Reading,1,3,A,2007-04-21,1,3,3,3,-2,0,0,3,-3
719,2007-04-21,Charlton,Sheffield United,1,1,D,2007-04-21,2,1,3,3,-1,-2,1,1,0
720,2007-04-21,Fulham,Blackburn,1,1,D,2007-04-21,1,4,1,1,0,3,1,1,0
721,2007-04-21,Liverpool,Wigan,2,0,H,2007-04-21,4,3,0,0,4,3,6,0,6
722,2007-04-21,Man United,Middlesbrough,1,1,D,2007-04-21,3,1,1,1,2,0,4,1,3
723,2007-04-21,Tottenham,Arsenal,2,2,D,2007-04-21,5,5,5,5,0,0,1,1,0
724,2007-04-21,Watford,Man City,1,1,D,2007-04-21,2,2,4,4,-2,-2,1,1,0
725,2007-04-21,West Ham,Everton,1,0,H,2007-04-21,2,2,4,4,-2,-2,3,0,3
726,2007-04-22,Aston Villa,Portsmouth,0,0,D,2007-04-28,2,2,0,0,2,2,1,1,0
727,2007-04-22,Newcastle,Chelsea,0,0,D,2007-04-28,0,2,0,0,0,2,1,1,0
728,2007-04-28,Blackburn,Charlton,4,1,H,2007-04-28,4,1,1,1,3,0,3,0,3
729,2007-04-28,Chelsea,Bolton,2,2,D,2007-04-28,2,2,2,2,0,0,1,1,0
730,2007-04-28,Everton,Man United,2,4,A,2007-04-28,2,4,4,4,-2,0,0,3,-3
731,2007-04-28,Man City,Aston Villa,0,2,A,2007-04-28,0,2,2,2,-2,0,0,3,-3
732,2007-04-28,Middlesbrough,Tottenham,2,3,A,2007-04-28,2,3,3,3,-1,0,0,3,-3
733,2007-04-28,Portsmouth,Liverpool,2,1,H,2007-04-28,2,1,1,1,1,0,3,0,3
734,2007-04-28,Sheffield United,Watford,1,0,H,2007-04-28,1,0,0,0,1,0,3,0,3
735,2007-04-28,Wigan,West Ham,0,3,A,2007-04-28,0,3,3,3,-3,0,0,3,-3
736,2007-04-29,Arsenal,Fulham,3,1,H,2007-05-05,3,2,1,1,2,1,3,0,3
737,2007-04-30,Reading,Newcastle,1,0,H,2007-05-05,1,0,2,2,-1,-2,3,0,3
738,2007-05-05,Aston Villa,Sheffield United,3,0,H,2007-05-05,3,0,0,0,3,0,3,0,3
739,2007-05-05,Everton,Portsmouth,3,0,H,2007-05-05,3,0,0,0,3,0,3,0,3
740,2007-05-05,Fulham,Liverpool,1,0,H,2007-05-05,2,0,3,3,-1,-3,3,0,3
741,2007-05-05,Man City,Man United,0,1,A,2007-05-05,0,1,1,1,-1,0,0,3,-3
742,2007-05-05,Newcastle,Blackburn,0,2,A,2007-05-05,0,2,3,3,-3,-1,0,3,-3
743,2007-05-05,Reading,Watford,0,2,A,2007-05-05,1,2,2,2,-1,0,3,3,0
744,2007-05-05,West Ham,Bolton,3,1,H,2007-05-05,3,1,1,1,2,0,3,0,3
745,2007-05-05,Wigan,Middlesbrough,0,1,A,2007-05-05,0,1,1,1,-1,0,0,3,-3
746,2007-05-06,Arsenal,Chelsea,1,1,D,2007-05-12,1,1,1,1,0,0,1,1,0
747,2007-05-07,Charlton,Tottenham,0,2,A,2007-05-12,0,3,2,2,-2,1,0,3,-3
748,2007-05-09,Chelsea,Man United,0,0,D,2007-05-12,1,0,1,1,0,-1,1,1,0
749,2007-05-10,Tottenham,Blackburn,1,1,D,2007-05-12,3,1,1,1,2,0,1,1,0
750,2007-05-13,Blackburn,Reading,3,3,D,2007-05-19,3,3,3,3,0,0,1,1,0
751,2007-05-13,Bolton,Aston Villa,2,2,D,2007-05-19,2,2,2,2,0,0,1,1,0
752,2007-05-13,Chelsea,Everton,1,1,D,2007-05-19,1,1,1,1,0,0,1,1,0
753,2007-05-13,Liverpool,Charlton,2,2,D,2007-05-19,2,2,2,2,0,0,1,1,0
754,2007-05-13,Man United,West Ham,0,1,A,2007-05-19,0,1,1,1,-1,0,0,3,-3
755,2007-05-13,Middlesbrough,Fulham,3,1,H,2007-05-19,3,1,1,1,2,0,3,0,3
756,2007-05-13,Portsmouth,Arsenal,0,0,D,2007-05-19,0,0,0,0,0,0,1,1,0
757,2007-05-13,Sheffield United,Wigan,1,2,A,2007-05-19,1,2,2,2,-1,0,0,3,-3
758,2007-05-13,Tottenham,Man City,2,1,H,2007-05-19,2,1,1,1,1,0,3,0,3
759,2007-05-13,Watford,Newcastle,1,1,D,2007-05-19,1,1,1,1,0,0,1,1,0
760,2007-08-11,Aston Villa,Liverpool,1,2,A,2007-08-11,1,2,2,2,-1,0,0,3,-3
761,2007-08-11,Bolton,Newcastle,1,3,A,2007-08-11,1,3,3,3,-2,0,0,3,-3
762,2007-08-11,Derby,Portsmouth,2,2,D,2007-08-11,2,2,2,2,0,0,1,1,0
763,2007-08-11,Everton,Wigan,2,1,H,2007-08-11,2,1,1,1,1,0,3,0,3
764,2007-08-11,Middlesbrough,Blackburn,1,2,A,2007-08-11,1,2,2,2,-1,0,0,3,-3
765,2007-08-11,Sunderland,Tottenham,1,0,H,2007-08-11,1,0,0,0,1,0,3,0,3
766,2007-08-11,West Ham,Man City,0,2,A,2007-08-11,0,2,2,2,-2,0,0,3,-3
767,2007-08-12,Arsenal,Fulham,2,1,H,2007-08-18,2,4,1,1,1,3,3,0,3
768,2007-08-12,Chelsea,Birmingham,3,2,H,2007-08-18,5,4,3,3,2,1,3,0,3
769,2007-08-12,Man United,Reading,0,0,D,2007-08-18,1,2,1,1,0,1,1,1,0
770,2007-08-14,Tottenham,Everton,1,3,A,2007-08-18,5,3,3,3,2,0,3,3,0
771,2007-08-15,Birmingham,Sunderland,2,2,D,2007-08-18,4,2,6,6,-2,-4,1,1,0
772,2007-08-15,Fulham,Bolton,2,1,H,2007-08-18,4,2,5,5,-1,-3,3,0,3
773,2007-08-15,Man City,Derby,1,0,H,2007-08-18,1,0,0,0,1,0,3,0,3
774,2007-08-15,Portsmouth,Man United,1,1,D,2007-08-18,4,1,2,2,2,-1,4,1,3
775,2007-08-15,Reading,Chelsea,1,2,A,2007-08-18,2,5,2,2,0,3,3,3,0
776,2007-08-15,Wigan,Middlesbrough,1,0,H,2007-08-18,4,2,0,0,4,2,6,3,3
777,2007-08-18,Birmingham,West Ham,0,1,A,2007-08-18,4,1,6,6,-2,-5,1,3,-2
778,2007-08-18,Fulham,Middlesbrough,1,2,A,2007-08-18,4,2,5,5,-1,-3,3,3,0
779,2007-08-18,Newcastle,Aston Villa,0,0,D,2007-08-18,0,0,0,0,0,0,1,1,0
780,2007-08-18,Portsmouth,Bolton,3,1,H,2007-08-18,4,2,2,2,2,0,4,0,4
781,2007-08-18,Reading,Everton,1,0,H,2007-08-18,2,3,2,2,0,1,3,3,0
782,2007-08-18,Tottenham,Derby,4,0,H,2007-08-18,5,0,3,3,2,-3,3,0,3
783,2007-08-18,Wigan,Sunderland,3,0,H,2007-08-18,4,2,0,0,4,2,6,1,5
784,2007-08-19,Blackburn,Arsenal,1,1,D,2007-08-25,2,2,2,2,0,0,1,1,0
785,2007-08-19,Liverpool,Chelsea,1,1,D,2007-08-25,3,2,1,1,2,1,1,1,0
786,2007-08-19,Man City,Man United,1,0,H,2007-08-25,1,0,1,1,0,-1,3,0,3
787,2007-08-25,Arsenal,Man City,1,0,H,2007-08-25,2,1,1,1,1,0,3,0,3
788,2007-08-25,Aston Villa,Fulham,2,1,H,2007-08-25,2,1,1,1,1,0,3,0,3
789,2007-08-25,Bolton,Reading,3,0,H,2007-08-25,3,0,0,0,3,0,3,0,3
790,2007-08-25,Chelsea,Portsmouth,1,0,H,2007-08-25,2,0,1,1,1,-1,3,0,3
791,2007-08-25,Derby,Birmingham,1,2,A,2007-08-25,1,2,2,2,-1,0,0,3,-3
792,2007-08-25,Everton,Blackburn,1,1,D,2007-08-25,1,2,1,1,0,1,1,1,0
793,2007-08-25,Sunderland,Liverpool,0,2,A,2007-08-25,0,3,2,2,-2,1,0,3,-3
794,2007-08-25,West Ham,Wigan,1,1,D,2007-08-25,1,1,1,1,0,0,1,1,0
795,2007-08-26,Man United,Tottenham,1,0,H,2007-09-01,2,3,0,0,2,3,6,1,5
796,2007-08-26,Middlesbrough,Newcastle,2,2,D,2007-09-01,4,3,2,2,2,1,4,1,3
797,2007-09-01,Bolton,Everton,1,2,A,2007-09-01,1,2,2,2,-1,0,0,3,-3
798,2007-09-01,Fulham,Tottenham,3,3,D,2007-09-01,3,3,3,3,0,0,1,1,0
799,2007-09-01,Liverpool,Derby,6,0,H,2007-09-01,6,0,0,0,6,0,3,0,3
800,2007-09-01,Man United,Sunderland,1,0,H,2007-09-01,2,0,0,0,2,0,6,0,6
801,2007-09-01,Middlesbrough,Birmingham,2,0,H,2007-09-01,4,0,2,2,2,-2,4,0,4
802,2007-09-01,Newcastle,Wigan,1,0,H,2007-09-01,3,0,2,2,1,-2,3,0,3
803,2007-09-01,Reading,West Ham,0,3,A,2007-09-01,0,3,3,3,-3,0,0,3,-3
804,2007-09-02,Arsenal,Portsmouth,3,1,H,2007-09-08,3,1,1,1,2,0,3,0,3
805,2007-09-02,Aston Villa,Chelsea,2,0,H,2007-09-08,2,0,0,0,2,0,3,0,3
806,2007-09-02,Blackburn,Man City,1,0,H,2007-09-08,1,0,0,0,1,0,3,0,3
807,2007-09-15,Birmingham,Bolton,1,0,H,2007-09-15,1,0,0,0,1,0,3,0,3
808,2007-09-15,Chelsea,Blackburn,0,0,D,2007-09-15,0,0,0,0,0,0,1,1,0
809,2007-09-15,Everton,Man United,0,1,A,2007-09-15,0,1,1,1,-1,0,0,3,-3
810,2007-09-15,Portsmouth,Liverpool,0,0,D,2007-09-15,0,0,0,0,0,0,1,1,0
811,2007-09-15,Sunderland,Reading,2,1,H,2007-09-15,2,1,1,1,1,0,3,0,3
812,2007-09-15,Tottenham,Arsenal,1,3,A,2007-09-15,1,3,3,3,-2,0,0,3,-3
813,2007-09-15,West Ham,Middlesbrough,3,0,H,2007-09-15,3,0,0,0,3,0,3,0,3
814,2007-09-15,Wigan,Fulham,1,1,D,2007-09-15,1,1,1,1,0,0,1,1,0
815,2007-09-16,Man City,Aston Villa,1,0,H,2007-09-22,4,0,3,3,1,-3,3,0,3
816,2007-09-17,Derby,Newcastle,1,0,H,2007-09-22,1,0,5,5,-4,-5,3,0,3
817,2007-09-22,Arsenal,Derby,5,0,H,2007-09-22,5,1,0,0,5,1,3,0,3
818,2007-09-22,Fulham,Man City,3,3,D,2007-09-22,3,4,3,3,0,1,1,1,0
819,2007-09-22,Liverpool,Birmingham,0,0,D,2007-09-22,0,0,0,0,0,0,1,1,0
820,2007-09-22,Middlesbrough,Sunderland,2,2,D,2007-09-22,2,2,2,2,0,0,1,1,0
821,2007-09-22,Reading,Wigan,2,1,H,2007-09-22,2,1,1,1,1,0,3,0,3
822,2007-09-23,Aston Villa,Everton,2,0,H,2007-09-29,2,0,0,0,2,0,3,0,3
823,2007-09-23,Blackburn,Portsmouth,0,1,A,2007-09-29,2,8,2,2,0,6,0,3,-3
824,2007-09-23,Bolton,Tottenham,1,1,D,2007-09-29,2,1,2,2,0,-1,1,1,0
825,2007-09-23,Man United,Chelsea,2,0,H,2007-09-29,3,0,0,0,3,0,3,0,3
826,2007-09-23,Newcastle,West Ham,3,1,H,2007-09-29,4,1,4,4,0,-3,3,0,3
827,2007-09-29,Birmingham,Man United,0,1,A,2007-09-29,0,3,1,1,-1,2,0,3,-3
828,2007-09-29,Chelsea,Fulham,0,0,D,2007-09-29,0,0,2,2,-2,-2,1,1,0
829,2007-09-29,Derby,Bolton,1,1,D,2007-09-29,1,2,1,1,0,1,1,1,0
830,2007-09-29,Man City,Newcastle,3,1,H,2007-09-29,3,4,1,1,2,3,3,0,3
831,2007-09-29,Portsmouth,Reading,7,4,H,2007-09-29,8,4,4,4,4,0,3,0,3
832,2007-09-29,Sunderland,Blackburn,1,2,A,2007-09-29,1,2,2,2,-1,0,0,3,-3
833,2007-09-29,West Ham,Arsenal,0,1,A,2007-09-29,1,1,4,4,-3,-3,0,3,-3
834,2007-09-29,Wigan,Liverpool,0,1,A,2007-09-29,0,1,1,1,-1,0,0,3,-3
835,2007-09-30,Everton,Middlesbrough,2,0,H,2007-10-06,2,0,0,0,2,0,3,0,3
836,2007-10-01,Tottenham,Aston Villa,4,4,D,2007-10-06,4,5,4,4,0,1,1,1,0
837,2007-10-06,Aston Villa,West Ham,1,0,H,2007-10-06,5,0,4,4,1,-4,3,0,3
838,2007-10-06,Man United,Wigan,4,0,H,2007-10-06,4,0,0,0,4,0,3,0,3
839,2007-10-07,Arsenal,Sunderland,3,2,H,2007-10-13,3,2,2,2,1,0,3,0,3
840,2007-10-07,Blackburn,Birmingham,2,1,H,2007-10-13,2,1,1,1,1,0,3,0,3
841,2007-10-07,Bolton,Chelsea,0,1,A,2007-10-13,0,1,1,1,-1,0,0,3,-3
842,2007-10-07,Fulham,Portsmouth,0,2,A,2007-10-13,0,2,2,2,-2,0,0,3,-3
843,2007-10-07,Liverpool,Tottenham,2,2,D,2007-10-13,2,2,2,2,0,0,1,1,0
844,2007-10-07,Man City,Middlesbrough,3,1,H,2007-10-13,3,1,1,1,2,0,3,0,3
845,2007-10-07,Newcastle,Everton,3,2,H,2007-10-13,3,2,2,2,1,0,3,0,3
846,2007-10-07,Reading,Derby,1,0,H,2007-10-13,1,0,0,0,1,0,3,0,3
847,2007-10-20,Arsenal,Bolton,2,0,H,2007-10-20,2,0,0,0,2,0,3,0,3
848,2007-10-20,Aston Villa,Man United,1,4,A,2007-10-20,1,4,4,4,-3,0,0,3,-3
849,2007-10-20,Blackburn,Reading,4,2,H,2007-10-20,4,2,2,2,2,0,3,0,3
850,2007-10-20,Everton,Liverpool,1,2,A,2007-10-20,1,2,2,2,-1,0,0,3,-3
851,2007-10-20,Fulham,Derby,0,0,D,2007-10-20,0,0,0,0,0,0,1,1,0
852,2007-10-20,Man City,Birmingham,1,0,H,2007-10-20,1,0,0,0,1,0,3,0,3
853,2007-10-20,Middlesbrough,Chelsea,0,2,A,2007-10-20,0,2,2,2,-2,0,0,3,-3
854,2007-10-20,Wigan,Portsmouth,0,2,A,2007-10-20,0,2,2,2,-2,0,0,3,-3
855,2007-10-21,West Ham,Sunderland,3,1,H,2007-10-27,3,2,1,1,2,1,3,0,3
856,2007-10-22,Newcastle,Tottenham,3,1,H,2007-10-27,4,1,3,3,1,-2,3,0,3
857,2007-10-27,Birmingham,Wigan,3,2,H,2007-10-27,3,2,2,2,1,0,3,0,3
858,2007-10-27,Chelsea,Man City,6,0,H,2007-10-27,6,0,0,0,6,0,3,0,3
859,2007-10-27,Man United,Middlesbrough,4,1,H,2007-10-27,4,1,1,1,3,0,3,0,3
860,2007-10-27,Portsmouth,West Ham,0,0,D,2007-10-27,0,3,0,0,0,3,1,1,0
861,2007-10-27,Reading,Newcastle,2,1,H,2007-10-27,2,4,1,1,1,3,3,0,3
862,2007-10-27,Sunderland,Fulham,1,1,D,2007-10-27,2,1,4,4,-2,-3,1,1,0
863,2007-10-28,Bolton,Aston Villa,1,1,D,2007-11-03,1,3,1,1,0,2,1,1,0
864,2007-10-28,Derby,Everton,0,2,A,2007-11-03,0,5,4,4,-4,1,0,3,-3
865,2007-10-28,Liverpool,Arsenal,1,1,D,2007-11-03,1,3,1,1,0,2,1,1,0
866,2007-10-28,Tottenham,Blackburn,1,2,A,2007-11-03,2,2,3,3,-1,-1,0,3,-3
867,2007-11-03,Arsenal,Man United,2,2,D,2007-11-03,3,2,3,3,0,-1,1,1,0
868,2007-11-03,Aston Villa,Derby,2,0,H,2007-11-03,3,0,1,1,2,-1,3,0,3
869,2007-11-03,Blackburn,Liverpool,0,0,D,2007-11-03,2,1,1,1,1,0,1,1,0
870,2007-11-03,Everton,Birmingham,3,1,H,2007-11-03,5,1,1,1,4,0,3,0,3
871,2007-11-03,Fulham,Reading,3,1,H,2007-11-03,3,1,1,1,2,0,3,0,3
872,2007-11-03,Middlesbrough,Tottenham,1,1,D,2007-11-03,1,2,1,1,0,1,1,1,0
873,2007-11-03,Newcastle,Portsmouth,1,4,A,2007-11-03,1,4,4,4,-3,0,0,3,-3
874,2007-11-03,Wigan,Chelsea,0,2,A,2007-11-03,0,2,2,2,-2,0,0,3,-3
875,2007-11-04,West Ham,Bolton,1,1,D,2007-11-10,6,1,1,1,5,0,1,1,0
876,2007-11-05,Man City,Sunderland,1,0,H,2007-11-10,1,1,0,0,1,1,3,0,3
877,2007-11-10,Derby,West Ham,0,5,A,2007-11-10,0,6,5,5,-5,1,0,3,-3
878,2007-11-10,Liverpool,Fulham,2,0,H,2007-11-10,2,0,0,0,2,0,3,0,3
879,2007-11-10,Sunderland,Newcastle,1,1,D,2007-11-10,1,1,2,2,-1,-1,1,1,0
880,2007-11-11,Birmingham,Aston Villa,1,2,A,2007-11-17,1,2,2,2,-1,0,0,3,-3
881,2007-11-11,Bolton,Middlesbrough,0,0,D,2007-11-17,0,0,0,0,0,0,1,1,0
882,2007-11-11,Chelsea,Everton,1,1,D,2007-11-17,1,1,1,1,0,0,1,1,0
883,2007-11-11,Man United,Blackburn,2,0,H,2007-11-17,2,0,0,0,2,0,3,0,3
884,2007-11-11,Portsmouth,Man City,0,0,D,2007-11-17,0,0,0,0,0,0,1,1,0
885,2007-11-11,Tottenham,Wigan,4,0,H,2007-11-17,4,0,0,0,4,0,3,0,3
886,2007-11-12,Reading,Arsenal,1,3,A,2007-11-17,1,3,3,3,-2,0,0,3,-3
887,2007-11-24,Arsenal,Wigan,2,0,H,2007-11-24,2,0,0,0,2,0,3,0,3
888,2007-11-24,Birmingham,Portsmouth,0,2,A,2007-11-24,0,2,2,2,-2,0,0,3,-3
889,2007-11-24,Bolton,Man United,1,0,H,2007-11-24,1,0,0,0,1,0,3,0,3
890,2007-11-24,Derby,Chelsea,0,2,A,2007-11-24,0,2,2,2,-2,0,0,3,-3
891,2007-11-24,Everton,Sunderland,7,1,H,2007-11-24,7,1,1,1,6,0,3,0,3
892,2007-11-24,Man City,Reading,2,1,H,2007-11-24,2,1,1,1,1,0,3,0,3
893,2007-11-24,Middlesbrough,Aston Villa,0,3,A,2007-11-24,0,3,3,3,-3,0,0,3,-3
894,2007-11-24,Newcastle,Liverpool,0,3,A,2007-11-24,0,3,3,3,-3,0,0,3,-3
895,2007-11-25,Fulham,Blackburn,2,2,D,2007-12-01,2,5,2,2,0,3,1,1,0
896,2007-11-25,West Ham,Tottenham,1,1,D,2007-12-01,1,1,2,2,-1,-1,1,1,0
897,2007-11-28,Blackburn,Aston Villa,0,4,A,2007-12-01,5,5,7,7,-2,-2,3,3,0
898,2007-12-01,Aston Villa,Arsenal,1,2,A,2007-12-01,5,2,2,2,3,0,0,3,-3
899,2007-12-01,Blackburn,Newcastle,3,1,H,2007-12-01,5,1,7,7,-2,-6,3,0,3
900,2007-12-01,Chelsea,West Ham,1,0,H,2007-12-01,1,1,0,0,1,1,3,0,3
901,2007-12-01,Portsmouth,Everton,0,0,D,2007-12-01,0,0,0,0,0,0,1,1,0
902,2007-12-01,Reading,Middlesbrough,1,1,D,2007-12-01,1,1,1,1,0,0,1,1,0
903,2007-12-01,Sunderland,Derby,1,0,H,2007-12-01,1,0,0,0,1,0,3,0,3
904,2007-12-01,Wigan,Man City,1,1,D,2007-12-01,1,1,1,1,0,0,1,1,0
905,2007-12-02,Liverpool,Bolton,4,0,H,2007-12-08,5,0,3,3,2,-3,3,0,3
906,2007-12-02,Tottenham,Birmingham,2,3,A,2007-12-08,2,4,3,3,-1,1,0,3,-3
907,2007-12-03,Man United,Fulham,2,0,H,2007-12-08,6,0,1,1,5,-1,6,0,6
908,2007-12-05,Newcastle,Arsenal,1,1,D,2007-12-08,3,1,2,2,1,-1,4,1,3
909,2007-12-08,Aston Villa,Portsmouth,1,3,A,2007-12-08,1,3,3,3,-2,0,0,3,-3
910,2007-12-08,Chelsea,Sunderland,2,0,H,2007-12-08,2,0,0,0,2,0,3,0,3
911,2007-12-08,Everton,Fulham,3,0,H,2007-12-08,3,0,0,0,3,0,3,0,3
912,2007-12-08,Man United,Derby,4,1,H,2007-12-08,6,1,1,1,5,0,6,0,6
913,2007-12-08,Newcastle,Birmingham,2,1,H,2007-12-08,3,4,2,2,1,2,4,3,1
914,2007-12-08,Reading,Liverpool,3,1,H,2007-12-08,3,5,1,1,2,4,3,0,3
915,2007-12-09,Blackburn,West Ham,0,1,A,2007-12-15,3,1,6,6,-3,-5,0,3,-3
916,2007-12-09,Bolton,Wigan,4,1,H,2007-12-15,6,6,5,5,1,1,3,0,3
917,2007-12-09,Middlesbrough,Arsenal,2,1,H,2007-12-15,3,1,1,1,2,0,3,0,3
918,2007-12-09,Tottenham,Man City,2,1,H,2007-12-15,3,5,1,1,2,4,3,0,3
919,2007-12-15,Birmingham,Reading,1,1,D,2007-12-15,1,1,1,1,0,0,1,1,0
920,2007-12-15,Derby,Middlesbrough,0,1,A,2007-12-15,0,3,1,1,-1,2,0,3,-3
921,2007-12-15,Fulham,Newcastle,0,1,A,2007-12-15,0,1,1,1,-1,0,0,3,-3
922,2007-12-15,Man City,Bolton,4,2,H,2007-12-15,5,6,4,4,1,2,3,0,3
923,2007-12-15,Portsmouth,Tottenham,0,1,A,2007-12-15,0,3,1,1,-1,2,0,3,-3
924,2007-12-15,Sunderland,Aston Villa,1,1,D,2007-12-15,1,1,1,1,0,0,1,1,0
925,2007-12-15,West Ham,Everton,0,2,A,2007-12-15,1,2,2,2,-1,0,0,3,-3
926,2007-12-15,Wigan,Blackburn,5,3,H,2007-12-15,6,3,7,7,-1,-4,3,0,3
927,2007-12-16,Arsenal,Chelsea,1,0,H,2007-12-22,3,0,1,1,2,-1,6,0,6
928,2007-12-16,Liverpool,Man United,0,1,A,2007-12-22,4,1,2,2,2,-1,3,3,0
929,2007-12-22,Arsenal,Tottenham,2,1,H,2007-12-22,3,1,1,1,2,0,6,0,6
930,2007-12-22,Aston Villa,Man City,1,1,D,2007-12-22,1,1,1,1,0,0,1,1,0
931,2007-12-22,Bolton,Birmingham,3,0,H,2007-12-22,3,0,0,0,3,0,3,0,3
932,2007-12-22,Fulham,Wigan,1,1,D,2007-12-22,1,1,1,1,0,0,1,1,0
933,2007-12-22,Liverpool,Portsmouth,4,1,H,2007-12-22,4,1,2,2,2,-1,3,0,3
934,2007-12-22,Middlesbrough,West Ham,1,2,A,2007-12-22,1,2,2,2,-1,0,0,3,-3
935,2007-12-22,Reading,Sunderland,2,1,H,2007-12-22,2,1,1,1,1,0,3,0,3
936,2007-12-23,Blackburn,Chelsea,0,1,A,2007-12-29,2,7,3,3,-1,4,0,3,-3
937,2007-12-23,Man United,Everton,2,1,H,2007-12-29,7,4,3,3,4,1,3,0,3
938,2007-12-23,Newcastle,Derby,2,2,D,2007-12-29,3,3,5,5,-2,-2,1,1,0
939,2007-12-26,Birmingham,Middlesbrough,3,0,H,2007-12-29,4,1,1,1,3,0,4,3,1
940,2007-12-26,Chelsea,Aston Villa,4,4,D,2007-12-29,7,6,5,5,2,1,4,4,0
941,2007-12-26,Derby,Liverpool,1,2,A,2007-12-29,3,2,4,4,-1,-2,0,3,-3
942,2007-12-26,Everton,Bolton,2,0,H,2007-12-29,4,1,6,6,-2,-5,3,0,3
943,2007-12-26,Portsmouth,Arsenal,0,0,D,2007-12-29,0,4,1,1,-1,3,1,4,-3
944,2007-12-26,Sunderland,Man United,0,4,A,2007-12-29,3,7,5,5,-2,2,3,3,0
945,2007-12-26,Tottenham,Fulham,5,1,H,2007-12-29,11,2,5,5,6,-3,6,1,5
946,2007-12-26,West Ham,Reading,1,1,D,2007-12-29,3,5,2,2,1,3,4,1,3
947,2007-12-26,Wigan,Newcastle,1,0,H,2007-12-29,2,3,2,2,0,1,3,0,3
948,2007-12-27,Man City,Blackburn,2,2,D,2007-12-29,2,2,2,2,0,0,1,1,0
949,2007-12-29,Birmingham,Fulham,1,1,D,2007-12-29,4,2,1,1,3,1,4,1,3
950,2007-12-29,Chelsea,Newcastle,2,1,H,2007-12-29,7,3,5,5,2,-2,4,0,4
951,2007-12-29,Everton,Arsenal,1,4,A,2007-12-29,4,4,6,6,-2,-2,3,4,-1
952,2007-12-29,Portsmouth,Middlesbrough,0,1,A,2007-12-29,0,1,1,1,-1,0,1,3,-2
953,2007-12-29,Sunderland,Bolton,3,1,H,2007-12-29,3,1,5,5,-2,-4,3,0,3
954,2007-12-29,Tottenham,Reading,6,4,H,2007-12-29,11,5,5,5,6,0,6,1,5
955,2007-12-29,West Ham,Man United,2,1,H,2007-12-29,3,7,2,2,1,5,4,3,1
956,2007-12-29,Wigan,Aston Villa,1,2,A,2007-12-29,2,6,2,2,0,4,3,4,-1
957,2007-12-30,Derby,Blackburn,1,2,A,2008-01-05,1,3,3,3,-2,0,0,3,-3
958,2007-12-30,Man City,Liverpool,0,0,D,2008-01-05,2,1,0,0,2,1,1,1,0
959,2008-01-01,Arsenal,West Ham,2,0,H,2008-01-05,2,0,0,0,2,0,3,0,3
960,2008-01-01,Aston Villa,Tottenham,2,1,H,2008-01-05,2,1,1,1,1,0,3,0,3
961,2008-01-01,Fulham,Chelsea,1,2,A,2008-01-05,1,2,2,2,-1,0,0,3,-3
962,2008-01-01,Man United,Birmingham,1,0,H,2008-01-05,1,0,0,0,1,0,3,0,3
963,2008-01-01,Middlesbrough,Everton,0,2,A,2008-01-05,0,2,2,2,-2,0,0,3,-3
964,2008-01-01,Reading,Portsmouth,0,2,A,2008-01-05,0,2,2,2,-2,0,0,3,-3
965,2008-01-02,Blackburn,Sunderland,1,0,H,2008-01-05,3,0,1,1,2,-1,3,0,3
966,2008-01-02,Bolton,Derby,1,0,H,2008-01-05,1,1,0,0,1,1,3,0,3
967,2008-01-02,Liverpool,Wigan,1,1,D,2008-01-05,1,1,1,1,0,0,1,1,0
968,2008-01-02,Newcastle,Man City,0,2,A,2008-01-05,0,2,2,2,-2,0,0,3,-3
969,2008-01-12,Arsenal,Birmingham,1,1,D,2008-01-12,1,1,1,1,0,0,1,1,0
970,2008-01-12,Aston Villa,Reading,3,1,H,2008-01-12,3,1,1,1,2,0,3,0,3
971,2008-01-12,Chelsea,Tottenham,2,0,H,2008-01-12,2,0,0,0,2,0,3,0,3
972,2008-01-12,Derby,Wigan,0,1,A,2008-01-12,0,1,1,1,-1,0,0,3,-3
973,2008-01-12,Everton,Man City,1,0,H,2008-01-12,1,0,0,0,1,0,3,0,3
974,2008-01-12,Man United,Newcastle,6,0,H,2008-01-12,6,0,0,0,6,0,3,0,3
975,2008-01-12,Middlesbrough,Liverpool,1,1,D,2008-01-12,1,1,1,1,0,0,1,1,0
976,2008-01-12,West Ham,Fulham,2,1,H,2008-01-12,2,1,1,1,1,0,3,0,3
977,2008-01-13,Bolton,Blackburn,1,2,A,2008-01-19,1,3,2,2,-1,1,0,3,-3
978,2008-01-13,Sunderland,Portsmouth,2,0,H,2008-01-19,2,3,2,2,0,1,3,0,3
979,2008-01-19,Birmingham,Chelsea,0,1,A,2008-01-19,0,1,1,1,-1,0,0,3,-3
980,2008-01-19,Blackburn,Middlesbrough,1,1,D,2008-01-19,3,1,2,2,1,-1,1,1,0
981,2008-01-19,Fulham,Arsenal,0,3,A,2008-01-19,0,3,3,3,-3,0,0,3,-3
982,2008-01-19,Newcastle,Bolton,0,0,D,2008-01-19,0,1,0,0,0,1,1,1,0
983,2008-01-19,Portsmouth,Derby,3,1,H,2008-01-19,3,1,3,3,0,-2,3,0,3
984,2008-01-19,Reading,Man United,0,2,A,2008-01-19,0,2,2,2,-2,0,0,3,-3
985,2008-01-19,Tottenham,Sunderland,2,0,H,2008-01-19,2,2,0,0,2,2,3,0,3
986,2008-01-20,Man City,West Ham,1,1,D,2008-01-26,1,1,1,1,0,0,1,1,0
987,2008-01-20,Wigan,Everton,1,2,A,2008-01-26,1,2,2,2,-1,0,0,3,-3
988,2008-01-21,Liverpool,Aston Villa,2,2,D,2008-01-26,2,3,2,2,0,1,1,1,0
989,2008-01-26,Aston Villa,Blackburn,1,1,D,2008-01-26,3,1,3,3,0,-2,1,1,0
990,2008-01-29,Arsenal,Newcastle,3,0,H,2008-02-02,6,0,1,1,5,-1,3,0,3
991,2008-01-29,Bolton,Fulham,0,0,D,2008-02-02,2,0,0,0,2,0,1,1,0
992,2008-01-29,Middlesbrough,Wigan,1,0,H,2008-02-02,1,1,0,0,1,1,3,0,3
993,2008-01-29,Sunderland,Birmingham,2,0,H,2008-02-02,2,1,3,3,-1,-2,3,0,3
994,2008-01-30,Chelsea,Reading,1,0,H,2008-02-02,2,0,1,1,1,-1,3,0,3
995,2008-01-30,Derby,Man City,1,1,D,2008-02-02,2,2,2,2,0,0,1,1,0
996,2008-01-30,Everton,Tottenham,0,0,D,2008-02-02,0,1,0,0,0,1,1,1,0
997,2008-01-30,Man United,Portsmouth,2,0,H,2008-02-02,3,1,1,1,2,0,3,0,3
998,2008-01-30,West Ham,Liverpool,1,0,H,2008-02-02,1,3,1,1,0,2,3,0,3
999,2008-02-02,Birmingham,Derby,1,1,D,2008-02-02,1,2,3,3,-2,-1,1,1,0
1000,2008-02-02,Blackburn,Everton,0,0,D,2008-02-02,0,0,0,0,0,0,1,1,0
1001,2008-02-02,Liverpool,Sunderland,3,0,H,2008-02-02,3,2,1,1,2,1,3,0,3
1002,2008-02-02,Man City,Arsenal,1,3,A,2008-02-02,2,6,4,4,-2,2,0,3,-3
1003,2008-02-02,Portsmouth,Chelsea,1,1,D,2008-02-02,1,2,3,3,-2,-1,1,1,0
1004,2008-02-02,Reading,Bolton,0,2,A,2008-02-02,0,2,3,3,-3,-1,0,3,-3
1005,2008-02-02,Tottenham,Man United,1,1,D,2008-02-02,1,3,1,1,0,2,1,1,0
1006,2008-02-02,Wigan,West Ham,1,0,H,2008-02-02,1,1,1,1,0,0,3,0,3
1007,2008-02-03,Fulham,Aston Villa,2,1,H,2008-02-09,2,5,2,2,0,3,3,0,3
1008,2008-02-03,Newcastle,Middlesbrough,1,1,D,2008-02-09,2,2,5,5,-3,-3,1,1,0
1009,2008-02-09,Aston Villa,Newcastle,4,1,H,2008-02-09,5,2,3,3,2,-1,3,0,3
1010,2008-02-09,Bolton,Portsmouth,0,1,A,2008-02-09,0,1,1,1,-1,0,0,3,-3
1011,2008-02-09,Derby,Tottenham,0,3,A,2008-02-09,0,3,3,3,-3,0,0,3,-3
1012,2008-02-09,Everton,Reading,1,0,H,2008-02-09,1,0,0,0,1,0,3,0,3
1013,2008-02-09,Middlesbrough,Fulham,1,0,H,2008-02-09,2,2,1,1,1,1,3,0,3
1014,2008-02-09,Sunderland,Wigan,2,0,H,2008-02-09,2,0,0,0,2,0,3,0,3
1015,2008-02-09,West Ham,Birmingham,1,1,D,2008-02-09,1,1,1,1,0,0,1,1,0
1016,2008-02-10,Chelsea,Liverpool,0,0,D,2008-02-16,0,0,0,0,0,0,1,1,0
1017,2008-02-10,Man United,Man City,1,2,A,2008-02-16,1,2,2,2,-1,0,0,3,-3
1018,2008-02-11,Arsenal,Blackburn,2,0,H,2008-02-16,2,0,0,0,2,0,3,0,3
1019,2008-02-23,Birmingham,Arsenal,2,2,D,2008-02-23,2,2,2,2,0,0,1,1,0
1020,2008-02-23,Fulham,West Ham,0,1,A,2008-02-23,0,1,1,1,-1,0,0,3,-3
1021,2008-02-23,Liverpool,Middlesbrough,3,2,H,2008-02-23,3,2,2,2,1,0,3,0,3
1022,2008-02-23,Newcastle,Man United,1,5,A,2008-02-23,1,5,5,5,-4,0,0,3,-3
1023,2008-02-23,Portsmouth,Sunderland,1,0,H,2008-02-23,1,0,0,0,1,0,3,0,3
1024,2008-02-23,Wigan,Derby,2,0,H,2008-02-23,2,0,0,0,2,0,3,0,3
1025,2008-02-24,Blackburn,Bolton,4,1,H,2008-03-01,5,1,1,1,4,0,3,0,3
1026,2008-02-24,Reading,Aston Villa,1,2,A,2008-03-01,2,3,2,2,0,1,0,4,-4
1027,2008-02-25,Man City,Everton,0,2,A,2008-03-01,0,2,2,2,-2,0,1,3,-2
1028,2008-03-01,Arsenal,Aston Villa,1,1,D,2008-03-01,1,3,1,1,0,2,1,4,-3
1029,2008-03-01,Birmingham,Tottenham,4,1,H,2008-03-01,4,1,1,1,3,0,3,0,3
1030,2008-03-01,Derby,Sunderland,0,0,D,2008-03-01,0,0,0,0,0,0,1,1,0
1031,2008-03-01,Fulham,Man United,0,3,A,2008-03-01,0,3,3,3,-3,0,0,3,-3
1032,2008-03-01,Man City,Wigan,0,0,D,2008-03-01,0,0,2,2,-2,-2,1,1,0
1033,2008-03-01,Middlesbrough,Reading,0,1,A,2008-03-01,0,2,1,1,-1,1,0,3,-3
1034,2008-03-01,Newcastle,Blackburn,0,1,A,2008-03-01,0,5,1,1,-1,4,0,3,-3
1035,2008-03-01,West Ham,Chelsea,0,4,A,2008-03-01,0,4,4,4,-4,0,0,3,-3
1036,2008-03-02,Bolton,Liverpool,1,3,A,2008-03-08,1,10,3,3,-2,7,0,3,-3
1037,2008-03-02,Everton,Portsmouth,3,1,H,2008-03-08,3,1,1,1,2,0,3,0,3
1038,2008-03-05,Liverpool,West Ham,4,0,H,2008-03-08,10,0,1,1,9,-1,6,0,6
1039,2008-03-08,Blackburn,Fulham,1,1,D,2008-03-08,1,1,1,1,0,0,1,1,0
1040,2008-03-08,Liverpool,Newcastle,3,0,H,2008-03-08,10,0,1,1,9,-1,6,0,6
1041,2008-03-08,Reading,Man City,2,0,H,2008-03-08,2,0,0,0,2,0,3,0,3
1042,2008-03-09,Sunderland,Everton,0,1,A,2008-03-15,0,1,2,2,-2,-1,0,3,-3
1043,2008-03-09,Tottenham,West Ham,4,0,H,2008-03-15,4,2,0,0,4,2,3,0,3
1044,2008-03-09,Wigan,Arsenal,0,0,D,2008-03-15,0,1,0,0,0,1,1,1,0
1045,2008-03-12,Aston Villa,Middlesbrough,1,1,D,2008-03-15,1,2,3,3,-2,-1,1,2,-1
1046,2008-03-12,Chelsea,Derby,6,1,H,2008-03-15,7,1,1,1,6,0,3,0,3
1047,2008-03-12,Portsmouth,Birmingham,4,2,H,2008-03-15,6,2,2,2,4,0,6,0,6
1048,2008-03-15,Arsenal,Middlesbrough,1,1,D,2008-03-15,1,2,1,1,0,1,1,2,-1
1049,2008-03-15,Derby,Man United,0,1,A,2008-03-15,1,1,7,7,-6,-6,0,3,-3
1050,2008-03-15,Liverpool,Reading,2,1,H,2008-03-15,2,1,1,1,1,0,3,0,3
1051,2008-03-15,Portsmouth,Aston Villa,2,0,H,2008-03-15,6,1,2,2,4,-1,6,0,6
1052,2008-03-15,Sunderland,Chelsea,0,1,A,2008-03-15,0,7,2,2,-2,5,0,3,-3
1053,2008-03-15,West Ham,Blackburn,2,1,H,2008-03-15,2,1,5,5,-3,-4,3,0,3
1054,2008-03-16,Fulham,Everton,1,0,H,2008-03-22,1,1,2,2,-1,-1,3,0,3
1055,2008-03-16,Man City,Tottenham,2,1,H,2008-03-22,2,7,1,1,1,6,3,0,3
1056,2008-03-16,Wigan,Bolton,1,0,H,2008-03-22,2,0,3,3,-1,-3,3,0,3
1057,2008-03-17,Birmingham,Newcastle,1,1,D,2008-03-22,2,3,3,3,-1,0,1,1,0
1058,2008-03-19,Man United,Bolton,2,0,H,2008-03-22,2,0,0,0,2,0,3,0,3
1059,2008-03-19,Tottenham,Chelsea,4,4,D,2008-03-22,7,4,6,6,1,-2,4,1,3
1060,2008-03-22,Aston Villa,Sunderland,0,1,A,2008-03-22,0,1,1,1,-1,0,0,3,-3
1061,2008-03-22,Blackburn,Wigan,3,1,H,2008-03-22,3,2,1,1,2,1,3,0,3
1062,2008-03-22,Bolton,Man City,0,0,D,2008-03-22,0,2,3,3,-3,-1,1,1,0
1063,2008-03-22,Everton,West Ham,1,1,D,2008-03-22,1,1,2,2,-1,-1,1,1,0
1064,2008-03-22,Middlesbrough,Derby,1,0,H,2008-03-22,1,0,0,0,1,0,3,0,3
1065,2008-03-22,Newcastle,Fulham,2,0,H,2008-03-22,3,1,1,1,2,0,3,0,3
1066,2008-03-22,Reading,Birmingham,2,1,H,2008-03-22,2,2,1,1,1,1,3,0,3
1067,2008-03-22,Tottenham,Portsmouth,2,0,H,2008-03-22,7,0,6,6,1,-6,4,0,4
1068,2008-03-23,Chelsea,Arsenal,2,1,H,2008-03-29,2,4,1,1,1,3,3,3,0
1069,2008-03-23,Man United,Liverpool,3,0,H,2008-03-29,7,0,0,0,7,0,6,0,6
1070,2008-03-29,Birmingham,Man City,3,1,H,2008-03-29,3,1,1,1,2,0,3,0,3
1071,2008-03-29,Bolton,Arsenal,2,3,A,2008-03-29,2,4,3,3,-1,1,0,3,-3
1072,2008-03-29,Derby,Fulham,2,2,D,2008-03-29,2,2,2,2,0,0,1,1,0
1073,2008-03-29,Man United,Aston Villa,4,0,H,2008-03-29,7,0,0,0,7,0,6,0,6
1074,2008-03-29,Portsmouth,Wigan,2,0,H,2008-03-29,2,0,0,0,2,0,3,0,3
1075,2008-03-29,Reading,Blackburn,0,0,D,2008-03-29,0,0,0,0,0,0,1,1,0
1076,2008-03-29,Sunderland,West Ham,2,1,H,2008-03-29,2,1,1,1,1,0,3,0,3
1077,2008-03-30,Chelsea,Middlesbrough,1,0,H,2008-04-05,3,0,0,0,3,0,3,0,3
1078,2008-03-30,Liverpool,Everton,1,0,H,2008-04-05,2,0,1,1,1,-1,3,0,3
1079,2008-03-30,Tottenham,Newcastle,1,4,A,2008-04-05,2,7,5,5,-3,2,0,3,-3
1080,2008-04-05,Arsenal,Liverpool,1,1,D,2008-04-05,1,2,1,1,0,1,1,1,0
1081,2008-04-05,Aston Villa,Bolton,4,0,H,2008-04-05,4,0,0,0,4,0,3,0,3
1082,2008-04-05,Blackburn,Tottenham,1,1,D,2008-04-05,1,2,1,1,0,1,1,1,0
1083,2008-04-05,Fulham,Sunderland,1,3,A,2008-04-05,1,3,3,3,-2,0,0,3,-3
1084,2008-04-05,Man City,Chelsea,0,2,A,2008-04-05,0,3,2,2,-2,1,0,3,-3
1085,2008-04-05,Newcastle,Reading,3,0,H,2008-04-05,7,0,1,1,6,-1,3,0,3
1086,2008-04-05,Wigan,Birmingham,2,0,H,2008-04-05,2,0,0,0,2,0,3,0,3
1087,2008-04-06,Everton,Derby,1,0,H,2008-04-12,2,0,1,1,1,-1,3,0,3
1088,2008-04-06,Middlesbrough,Man United,2,2,D,2008-04-12,3,2,3,3,0,-1,1,1,0
1089,2008-04-08,West Ham,Portsmouth,0,1,A,2008-04-12,0,1,2,2,-2,-1,0,3,-3
1090,2008-04-12,Birmingham,Everton,1,1,D,2008-04-12,1,2,1,1,0,1,1,1,0
1091,2008-04-12,Bolton,West Ham,1,0,H,2008-04-12,1,0,0,0,1,0,3,0,3
1092,2008-04-12,Derby,Aston Villa,0,6,A,2008-04-12,0,6,7,7,-7,-1,0,3,-3
1093,2008-04-12,Portsmouth,Newcastle,0,0,D,2008-04-12,1,0,0,0,1,0,1,1,0
1094,2008-04-12,Reading,Fulham,0,2,A,2008-04-12,0,2,2,2,-2,0,0,3,-3
1095,2008-04-12,Sunderland,Man City,1,2,A,2008-04-12,1,2,2,2,-1,0,0,3,-3
1096,2008-04-12,Tottenham,Middlesbrough,1,1,D,2008-04-12,1,3,1,1,0,2,1,1,0
1097,2008-04-13,Liverpool,Blackburn,3,1,H,2008-04-19,5,2,1,1,4,1,3,0,3
1098,2008-04-13,Man United,Arsenal,2,1,H,2008-04-19,3,3,2,2,1,1,3,0,3
1099,2008-04-14,Chelsea,Wigan,1,1,D,2008-04-19,2,2,1,1,1,1,1,1,0
1100,2008-04-17,Everton,Chelsea,0,1,A,2008-04-19,0,2,1,1,-1,1,0,3,-3
1101,2008-04-19,Arsenal,Reading,2,0,H,2008-04-19,3,0,2,2,1,-2,3,0,3
1102,2008-04-19,Blackburn,Man United,1,1,D,2008-04-19,2,3,4,4,-2,-1,1,1,0
1103,2008-04-19,Fulham,Liverpool,0,2,A,2008-04-19,0,5,2,2,-2,3,0,3,-3
1104,2008-04-19,Middlesbrough,Bolton,0,1,A,2008-04-19,0,1,1,1,-1,0,0,3,-3
1105,2008-04-19,West Ham,Derby,2,1,H,2008-04-19,2,1,1,1,1,0,3,0,3
1106,2008-04-19,Wigan,Tottenham,1,1,D,2008-04-19,2,1,2,2,0,-1,1,1,0
1107,2008-04-20,Aston Villa,Birmingham,5,1,H,2008-04-26,5,3,1,1,4,2,3,0,3
1108,2008-04-20,Man City,Portsmouth,3,1,H,2008-04-26,5,1,4,4,1,-3,3,0,3
1109,2008-04-20,Newcastle,Sunderland,2,0,H,2008-04-26,4,3,2,2,2,1,3,0,3
1110,2008-04-26,Birmingham,Liverpool,2,2,D,2008-04-26,3,2,7,7,-4,-5,1,1,0
1111,2008-04-26,Chelsea,Man United,2,1,H,2008-04-26,2,1,1,1,1,0,3,0,3
1112,2008-04-26,Man City,Fulham,2,3,A,2008-04-26,5,3,4,4,1,-1,3,3,0
1113,2008-04-26,Sunderland,Middlesbrough,3,2,H,2008-04-26,3,2,4,4,-1,-2,3,0,3
1114,2008-04-26,Tottenham,Bolton,1,1,D,2008-04-26,1,1,1,1,0,0,1,1,0
1115,2008-04-26,West Ham,Newcastle,2,2,D,2008-04-26,2,4,2,2,0,2,1,1,0
1116,2008-04-26,Wigan,Reading,0,0,D,2008-04-26,0,0,0,0,0,0,1,1,0
1117,2008-04-27,Everton,Aston Villa,2,2,D,2008-05-03,2,2,2,2,0,0,1,1,0
1118,2008-04-27,Portsmouth,Blackburn,0,1,A,2008-05-03,0,4,3,3,-3,1,0,3,-3
1119,2008-04-28,Derby,Arsenal,2,6,A,2008-05-03,3,6,9,9,-6,-3,0,3,-3
1120,2008-05-03,Aston Villa,Wigan,0,2,A,2008-05-03,2,2,4,4,-2,-2,0,3,-3
1121,2008-05-03,Blackburn,Derby,3,1,H,2008-05-03,4,3,1,1,3,2,3,0,3
1122,2008-05-03,Bolton,Sunderland,2,0,H,2008-05-03,2,0,0,0,2,0,3,0,3
1123,2008-05-03,Fulham,Birmingham,2,0,H,2008-05-03,2,0,0,0,2,0,3,0,3
1124,2008-05-03,Man United,West Ham,4,1,H,2008-05-03,4,1,1,1,3,0,3,0,3
1125,2008-05-03,Middlesbrough,Portsmouth,2,0,H,2008-05-03,2,0,0,0,2,0,3,0,3
1126,2008-05-03,Reading,Tottenham,0,1,A,2008-05-03,0,1,1,1,-1,0,0,3,-3
1127,2008-05-04,Arsenal,Everton,1,0,H,2008-05-10,1,0,0,0,1,0,3,0,3
1128,2008-05-04,Liverpool,Man City,1,0,H,2008-05-10,1,0,0,0,1,0,3,0,3
1129,2008-05-05,Newcastle,Chelsea,0,2,A,2008-05-10,0,2,2,2,-2,0,0,3,-3
1130,2008-05-11,Birmingham,Blackburn,4,1,H,2008-05-17,4,1,1,1,3,0,3,0,3
1131,2008-05-11,Chelsea,Bolton,1,1,D,2008-05-17,1,1,1,1,0,0,1,1,0
1132,2008-05-11,Derby,Reading,0,4,A,2008-05-17,0,4,4,4,-4,0,0,3,-3
1133,2008-05-11,Everton,Newcastle,3,1,H,2008-05-17,3,1,1,1,2,0,3,0,3
1134,2008-05-11,Middlesbrough,Man City,8,1,H,2008-05-17,8,1,1,1,7,0,3,0,3
1135,2008-05-11,Portsmouth,Fulham,0,1,A,2008-05-17,0,1,1,1,-1,0,0,3,-3
1136,2008-05-11,Sunderland,Arsenal,0,1,A,2008-05-17,0,1,1,1,-1,0,0,3,-3
1137,2008-05-11,Tottenham,Liverpool,0,2,A,2008-05-17,0,2,2,2,-2,0,0,3,-3
1138,2008-05-11,West Ham,Aston Villa,2,2,D,2008-05-17,2,2,2,2,0,0,1,1,0
1139,2008-05-11,Wigan,Man United,0,2,A,2008-05-17,0,2,2,2,-2,0,0,3,-3
1140,2008-08-16,Arsenal,West Brom,1,0,H,2008-08-16,1,0,0,0,1,0,3,0,3
1141,2008-08-16,Bolton,Stoke,3,1,H,2008-08-16,3,1,1,1,2,0,3,0,3
1142,2008-08-16,Everton,Blackburn,2,3,A,2008-08-16,2,3,3,3,-1,0,0,3,-3
1143,2008-08-16,Hull,Fulham,2,1,H,2008-08-16,2,1,1,1,1,0,3,0,3
1144,2008-08-16,Middlesbrough,Tottenham,2,1,H,2008-08-16,2,1,1,1,1,0,3,0,3
1145,2008-08-16,Sunderland,Liverpool,0,1,A,2008-08-16,0,1,1,1,-1,0,0,3,-3
1146,2008-08-16,West Ham,Wigan,2,1,H,2008-08-16,2,1,1,1,1,0,3,0,3
1147,2008-08-17,Aston Villa,Man City,4,2,H,2008-08-23,6,2,5,5,1,-3,3,0,3
1148,2008-08-17,Chelsea,Portsmouth,4,0,H,2008-08-23,4,0,0,0,4,0,3,0,3
1149,2008-08-17,Man United,Newcastle,1,1,D,2008-08-23,1,2,1,1,0,1,1,1,0
1150,2008-08-23,Blackburn,Hull,1,1,D,2008-08-23,1,1,1,1,0,0,1,1,0
1151,2008-08-23,Fulham,Arsenal,1,0,H,2008-08-23,1,0,0,0,1,0,3,0,3
1152,2008-08-23,Liverpool,Middlesbrough,2,1,H,2008-08-23,2,1,1,1,1,0,3,0,3
1153,2008-08-23,Newcastle,Bolton,1,0,H,2008-08-23,2,0,1,1,1,-1,3,0,3
1154,2008-08-23,Stoke,Aston Villa,3,2,H,2008-08-23,3,6,2,2,1,4,3,0,3
1155,2008-08-23,Tottenham,Sunderland,1,2,A,2008-08-23,1,2,2,2,-1,0,0,3,-3
1156,2008-08-23,West Brom,Everton,1,2,A,2008-08-23,1,2,2,2,-1,0,0,3,-3
1157,2008-08-24,Man City,West Ham,3,0,H,2008-08-30,3,4,0,0,3,4,3,0,3
1158,2008-08-24,Wigan,Chelsea,0,1,A,2008-08-30,5,1,1,1,4,0,0,3,-3
1159,2008-08-25,Portsmouth,Man United,0,1,A,2008-08-30,3,1,1,1,2,0,0,3,-3
1160,2008-08-30,Arsenal,Newcastle,3,0,H,2008-08-30,3,0,0,0,3,0,3,0,3
1161,2008-08-30,Bolton,West Brom,0,0,D,2008-08-30,0,0,0,0,0,0,1,1,0
1162,2008-08-30,Everton,Portsmouth,0,3,A,2008-08-30,0,3,3,3,-3,0,0,3,-3
1163,2008-08-30,Hull,Wigan,0,5,A,2008-08-30,0,5,5,5,-5,0,0,3,-3
1164,2008-08-30,Middlesbrough,Stoke,2,1,H,2008-08-30,2,1,1,1,1,0,3,0,3
1165,2008-08-30,West Ham,Blackburn,4,1,H,2008-08-30,4,1,4,4,0,-3,3,0,3
1166,2008-08-31,Aston Villa,Liverpool,0,0,D,2008-09-06,0,0,0,0,0,0,1,1,0
1167,2008-08-31,Chelsea,Tottenham,1,1,D,2008-09-06,1,1,1,1,0,0,1,1,0
1168,2008-08-31,Sunderland,Man City,0,3,A,2008-09-06,0,3,3,3,-3,0,0,3,-3
1169,2008-09-13,Blackburn,Arsenal,0,4,A,2008-09-13,0,4,4,4,-4,0,0,3,-3
1170,2008-09-13,Fulham,Bolton,2,1,H,2008-09-13,2,1,1,1,1,0,3,0,3
1171,2008-09-13,Liverpool,Man United,2,1,H,2008-09-13,2,1,1,1,1,0,3,0,3
1172,2008-09-13,Man City,Chelsea,1,3,A,2008-09-13,1,3,3,3,-2,0,0,3,-3
1173,2008-09-13,Newcastle,Hull,1,2,A,2008-09-13,1,2,2,2,-1,0,0,3,-3
1174,2008-09-13,Portsmouth,Middlesbrough,2,1,H,2008-09-13,2,1,1,1,1,0,3,0,3
1175,2008-09-13,West Brom,West Ham,3,2,H,2008-09-13,3,2,2,2,1,0,3,0,3
1176,2008-09-13,Wigan,Sunderland,1,1,D,2008-09-13,1,1,1,1,0,0,1,1,0
1177,2008-09-14,Stoke,Everton,2,3,A,2008-09-20,2,3,3,3,-1,0,0,3,-3
1178,2008-09-15,Tottenham,Aston Villa,1,2,A,2008-09-20,1,2,2,2,-1,0,0,3,-3
1179,2008-09-20,Blackburn,Fulham,1,0,H,2008-09-20,1,0,0,0,1,0,3,0,3
1180,2008-09-20,Bolton,Arsenal,1,3,A,2008-09-20,1,3,3,3,-2,0,0,3,-3
1181,2008-09-20,Liverpool,Stoke,0,0,D,2008-09-20,0,2,0,0,0,2,1,1,0
1182,2008-09-20,Sunderland,Middlesbrough,2,0,H,2008-09-20,2,0,0,0,2,0,3,0,3
1183,2008-09-20,West Ham,Newcastle,3,1,H,2008-09-20,3,1,1,1,2,0,3,0,3
1184,2008-09-21,Chelsea,Man United,1,1,D,2008-09-27,3,3,1,1,2,2,1,1,0
1185,2008-09-21,Hull,Everton,2,2,D,2008-09-27,4,2,3,3,1,-1,1,1,0
1186,2008-09-21,Man City,Portsmouth,6,0,H,2008-09-27,6,0,0,0,6,0,3,0,3
1187,2008-09-21,Tottenham,Wigan,0,0,D,2008-09-27,0,0,0,0,0,0,1,1,0
1188,2008-09-21,West Brom,Aston Villa,1,2,A,2008-09-27,2,4,2,2,0,2,0,3,-3
1189,2008-09-27,Arsenal,Hull,1,2,A,2008-09-27,1,4,2,2,-1,2,0,3,-3
1190,2008-09-27,Aston Villa,Sunderland,2,1,H,2008-09-27,4,1,2,2,2,-1,3,0,3
1191,2008-09-27,Everton,Liverpool,0,2,A,2008-09-27,2,2,4,4,-2,-2,0,3,-3
1192,2008-09-27,Fulham,West Ham,1,2,A,2008-09-27,1,2,2,2,-1,0,0,3,-3
1193,2008-09-27,Man United,Bolton,2,0,H,2008-09-27,3,0,1,1,2,-1,3,0,3
1194,2008-09-27,Middlesbrough,West Brom,0,1,A,2008-09-27,0,2,1,1,-1,1,0,3,-3
1195,2008-09-27,Newcastle,Blackburn,1,2,A,2008-09-27,1,2,2,2,-1,0,0,3,-3
1196,2008-09-27,Stoke,Chelsea,0,2,A,2008-09-27,0,3,2,2,-2,1,0,3,-3
1197,2008-09-28,Portsmouth,Tottenham,2,0,H,2008-10-04,2,0,0,0,2,0,3,0,3
1198,2008-09-28,Wigan,Man City,2,1,H,2008-10-04,2,1,2,2,0,-1,3,0,3
1199,2008-10-04,Blackburn,Man United,0,2,A,2008-10-04,0,2,2,2,-2,0,0,3,-3
1200,2008-10-04,Sunderland,Arsenal,1,1,D,2008-10-04,1,1,1,1,0,0,1,1,0
1201,2008-10-04,West Brom,Fulham,1,0,H,2008-10-04,1,0,0,0,1,0,3,0,3
1202,2008-10-04,Wigan,Middlesbrough,0,1,A,2008-10-04,2,1,2,2,0,-1,3,3,0
1203,2008-10-05,Chelsea,Aston Villa,2,0,H,2008-10-11,2,0,0,0,2,0,3,0,3
1204,2008-10-05,Everton,Newcastle,2,2,D,2008-10-11,2,2,2,2,0,0,1,1,0
1205,2008-10-05,Man City,Liverpool,2,3,A,2008-10-11,2,3,3,3,-1,0,0,3,-3
1206,2008-10-05,Portsmouth,Stoke,2,1,H,2008-10-11,2,1,1,1,1,0,3,0,3
1207,2008-10-05,Tottenham,Hull,0,1,A,2008-10-11,0,1,1,1,-1,0,0,3,-3
1208,2008-10-05,West Ham,Bolton,1,3,A,2008-10-11,1,3,3,3,-2,0,0,3,-3
1209,2008-10-18,Arsenal,Everton,3,1,H,2008-10-18,3,1,1,1,2,0,3,0,3
1210,2008-10-18,Aston Villa,Portsmouth,0,0,D,2008-10-18,0,0,0,0,0,0,1,1,0
1211,2008-10-18,Bolton,Blackburn,0,0,D,2008-10-18,0,0,0,0,0,0,1,1,0
1212,2008-10-18,Fulham,Sunderland,0,0,D,2008-10-18,0,0,0,0,0,0,1,1,0
1213,2008-10-18,Liverpool,Wigan,3,2,H,2008-10-18,3,2,2,2,1,0,3,0,3
1214,2008-10-18,Man United,West Brom,4,0,H,2008-10-18,4,0,0,0,4,0,3,0,3
1215,2008-10-18,Middlesbrough,Chelsea,0,5,A,2008-10-18,0,5,5,5,-5,0,0,3,-3
1216,2008-10-19,Hull,West Ham,1,0,H,2008-10-25,4,0,0,0,4,0,3,0,3
1217,2008-10-19,Stoke,Tottenham,2,1,H,2008-10-25,2,1,1,1,1,0,3,0,3
1218,2008-10-20,Newcastle,Man City,2,2,D,2008-10-25,3,2,4,4,-1,-2,1,1,0
1219,2008-10-25,Blackburn,Middlesbrough,1,1,D,2008-10-25,1,1,1,1,0,0,1,1,0
1220,2008-10-25,Everton,Man United,1,1,D,2008-10-25,1,1,1,1,0,0,1,1,0
1221,2008-10-25,Sunderland,Newcastle,2,1,H,2008-10-25,2,3,1,1,1,2,3,0,3
1222,2008-10-25,West Brom,Hull,0,3,A,2008-10-25,0,4,3,3,-3,1,0,3,-3
1223,2008-10-26,Chelsea,Liverpool,0,1,A,2008-11-01,8,3,1,1,7,2,3,3,0
1224,2008-10-26,Man City,Stoke,3,0,H,2008-11-01,3,3,2,2,1,1,3,0,3
1225,2008-10-26,Portsmouth,Fulham,1,1,D,2008-11-01,2,3,4,4,-2,-1,1,1,0
1226,2008-10-26,Tottenham,Bolton,2,0,H,2008-11-01,8,0,5,5,3,-5,6,0,6
1227,2008-10-26,West Ham,Arsenal,0,2,A,2008-11-01,1,7,5,5,-4,2,0,3,-3
1228,2008-10-26,Wigan,Aston Villa,0,4,A,2008-11-01,2,7,7,7,-5,0,0,3,-3
1229,2008-10-28,Newcastle,West Brom,2,1,H,2008-11-01,2,3,1,1,1,2,3,0,3
1230,2008-10-29,Arsenal,Tottenham,4,4,D,2008-11-01,7,8,6,6,1,2,1,1,0
1231,2008-10-29,Aston Villa,Blackburn,3,2,H,2008-11-01,7,4,2,2,5,2,3,1,2
1232,2008-10-29,Bolton,Everton,0,1,A,2008-11-01,0,2,3,3,-3,-1,0,3,-3
1233,2008-10-29,Fulham,Wigan,2,0,H,2008-11-01,3,2,2,2,1,0,3,3,0
1234,2008-10-29,Hull,Chelsea,0,3,A,2008-11-01,3,8,7,7,-4,1,0,3,-3
1235,2008-10-29,Liverpool,Portsmouth,1,0,H,2008-11-01,3,2,2,2,1,0,3,0,3
1236,2008-10-29,Man United,West Ham,2,0,H,2008-11-01,6,1,3,3,3,-2,6,1,5
1237,2008-10-29,Middlesbrough,Man City,2,0,H,2008-11-01,3,3,1,1,2,2,4,0,4
1238,2008-10-29,Stoke,Sunderland,1,0,H,2008-11-01,3,0,4,4,-1,-4,6,0,6
1239,2008-11-01,Chelsea,Sunderland,5,0,H,2008-11-01,8,0,1,1,7,-1,3,0,3
1240,2008-11-01,Everton,Fulham,1,0,H,2008-11-01,2,3,0,0,2,3,3,1,2
1241,2008-11-01,Man United,Hull,4,3,H,2008-11-01,6,3,3,3,3,0,6,0,6
1242,2008-11-01,Middlesbrough,West Ham,1,1,D,2008-11-01,3,1,1,1,2,0,4,1,3
1243,2008-11-01,Portsmouth,Wigan,1,2,A,2008-11-01,2,2,4,4,-2,-2,1,3,-2
1244,2008-11-01,Stoke,Arsenal,2,1,H,2008-11-01,3,7,4,4,-1,3,6,3,3
1245,2008-11-01,Tottenham,Liverpool,2,1,H,2008-11-01,8,3,5,5,3,-2,6,3,3
1246,2008-11-01,West Brom,Blackburn,2,2,D,2008-11-01,3,4,4,4,-1,0,1,1,0
1247,2008-11-02,Bolton,Man City,2,0,H,2008-11-08,3,0,0,0,3,0,3,0,3
1248,2008-11-03,Newcastle,Aston Villa,2,0,H,2008-11-08,2,0,0,0,2,0,3,0,3
1249,2008-11-08,Arsenal,Man United,2,1,H,2008-11-08,2,1,1,1,1,0,3,0,3
1250,2008-11-08,Hull,Bolton,0,1,A,2008-11-08,0,3,1,1,-1,2,0,3,-3
1251,2008-11-08,Liverpool,West Brom,3,0,H,2008-11-08,3,0,0,0,3,0,3,0,3
1252,2008-11-08,Sunderland,Portsmouth,1,2,A,2008-11-08,1,2,2,2,-1,0,0,3,-3
1253,2008-11-08,West Ham,Everton,1,3,A,2008-11-08,1,3,3,3,-2,0,0,3,-3
1254,2008-11-08,Wigan,Stoke,0,0,D,2008-11-08,0,0,0,0,0,0,1,1,0
1255,2008-11-09,Aston Villa,Middlesbrough,1,2,A,2008-11-15,3,2,2,2,1,0,0,3,-3
1256,2008-11-09,Blackburn,Chelsea,0,2,A,2008-11-15,1,5,4,4,-3,1,0,6,-6
1257,2008-11-09,Fulham,Newcastle,2,1,H,2008-11-15,4,3,2,2,2,1,6,0,6
1258,2008-11-09,Man City,Tottenham,1,2,A,2008-11-15,1,3,2,2,-1,1,0,3,-3
1259,2008-11-15,Arsenal,Aston Villa,0,2,A,2008-11-15,0,3,2,2,-2,1,0,3,-3
1260,2008-11-15,Blackburn,Sunderland,1,2,A,2008-11-15,1,2,4,4,-3,-2,0,3,-3
1261,2008-11-15,Bolton,Liverpool,0,2,A,2008-11-15,0,2,2,2,-2,0,0,3,-3
1262,2008-11-15,Fulham,Tottenham,2,1,H,2008-11-15,4,3,2,2,2,1,6,3,3
1263,2008-11-15,Man United,Stoke,5,0,H,2008-11-15,5,0,0,0,5,0,3,0,3
1264,2008-11-15,Newcastle,Wigan,2,2,D,2008-11-15,3,2,4,4,-1,-2,1,1,0
1265,2008-11-15,West Brom,Chelsea,0,3,A,2008-11-15,0,5,3,3,-3,2,0,6,-6
1266,2008-11-15,West Ham,Portsmouth,0,0,D,2008-11-15,0,0,0,0,0,0,1,1,0
1267,2008-11-16,Everton,Middlesbrough,1,1,D,2008-11-22,1,2,1,1,0,1,1,1,0
1268,2008-11-16,Hull,Man City,2,2,D,2008-11-22,4,5,4,4,0,1,1,1,0
1269,2008-11-22,Aston Villa,Man United,0,0,D,2008-11-22,0,0,0,0,0,0,1,1,0
1270,2008-11-22,Chelsea,Newcastle,0,0,D,2008-11-22,0,0,0,0,0,0,1,1,0
1271,2008-11-22,Liverpool,Fulham,0,0,D,2008-11-22,0,0,0,0,0,0,1,1,0
1272,2008-11-22,Man City,Arsenal,3,0,H,2008-11-22,5,0,2,2,3,-2,3,0,3
1273,2008-11-22,Middlesbrough,Bolton,1,3,A,2008-11-22,2,3,4,4,-2,-1,0,3,-3
1274,2008-11-22,Portsmouth,Hull,2,2,D,2008-11-22,2,4,2,2,0,2,1,1,0
1275,2008-11-22,Stoke,West Brom,1,0,H,2008-11-22,1,0,0,0,1,0,3,0,3
1276,2008-11-23,Sunderland,West Ham,0,1,A,2008-11-29,1,1,5,5,-4,-4,0,3,-3
1277,2008-11-23,Tottenham,Blackburn,1,0,H,2008-11-29,1,0,0,0,1,0,3,0,3
1278,2008-11-24,Wigan,Everton,1,0,H,2008-11-29,3,0,1,1,2,-1,6,0,6
1279,2008-11-29,Aston Villa,Fulham,0,0,D,2008-11-29,0,0,0,0,0,0,1,1,0
1280,2008-11-29,Middlesbrough,Newcastle,0,0,D,2008-11-29,0,0,0,0,0,0,1,1,0
1281,2008-11-29,Stoke,Hull,1,1,D,2008-11-29,1,1,1,1,0,0,1,1,0
1282,2008-11-29,Sunderland,Bolton,1,4,A,2008-11-29,1,4,5,5,-4,-1,0,3,-3
1283,2008-11-29,Wigan,West Brom,2,1,H,2008-11-29,3,1,1,1,2,0,6,0,6
1284,2008-11-30,Chelsea,Arsenal,1,2,A,2008-12-06,3,3,2,2,1,1,0,3,-3
1285,2008-11-30,Man City,Man United,0,1,A,2008-12-06,1,2,2,2,-1,0,0,3,-3
1286,2008-11-30,Portsmouth,Blackburn,3,2,H,2008-12-06,3,3,2,2,1,1,3,0,3
1287,2008-11-30,Tottenham,Everton,0,1,A,2008-12-06,0,1,1,1,-1,0,0,3,-3
1288,2008-12-01,Liverpool,West Ham,0,0,D,2008-12-06,3,0,1,1,2,-1,1,1,0
1289,2008-12-06,Arsenal,Wigan,1,0,H,2008-12-06,3,0,1,1,2,-1,3,0,3
1290,2008-12-06,Blackburn,Liverpool,1,3,A,2008-12-06,3,3,6,6,-3,-3,0,3,-3
1291,2008-12-06,Bolton,Chelsea,0,2,A,2008-12-06,0,3,2,2,-2,1,0,3,-3
1292,2008-12-06,Fulham,Man City,1,1,D,2008-12-06,1,1,1,1,0,0,1,1,0
1293,2008-12-06,Hull,Middlesbrough,2,1,H,2008-12-06,2,1,1,1,1,0,3,0,3
1294,2008-12-06,Man United,Sunderland,1,0,H,2008-12-06,2,0,0,0,2,0,3,0,3
1295,2008-12-06,Newcastle,Stoke,2,2,D,2008-12-06,2,2,2,2,0,0,1,1,0
1296,2008-12-07,Everton,Aston Villa,2,3,A,2008-12-13,3,7,3,3,0,4,0,3,-3
1297,2008-12-07,West Brom,Portsmouth,1,1,D,2008-12-13,1,1,5,5,-4,-4,1,1,0
1298,2008-12-08,West Ham,Tottenham,0,2,A,2008-12-13,0,2,2,2,-2,0,0,3,-3
1299,2008-12-13,Aston Villa,Bolton,4,2,H,2008-12-13,7,2,4,4,3,-2,3,0,3
1300,2008-12-13,Liverpool,Hull,2,2,D,2008-12-13,2,2,2,2,0,0,1,1,0
1301,2008-12-13,Man City,Everton,0,1,A,2008-12-13,0,3,1,1,-1,2,0,3,-3
1302,2008-12-13,Middlesbrough,Arsenal,1,1,D,2008-12-13,1,1,1,1,0,0,1,1,0
1303,2008-12-13,Stoke,Fulham,0,0,D,2008-12-13,0,0,0,0,0,0,1,1,0
1304,2008-12-13,Sunderland,West Brom,4,0,H,2008-12-13,4,1,0,0,4,1,3,0,3
1305,2008-12-13,Tottenham,Man United,0,0,D,2008-12-13,2,0,0,0,2,0,1,1,0
1306,2008-12-13,Wigan,Blackburn,3,0,H,2008-12-13,3,0,0,0,3,0,3,0,3
1307,2008-12-14,Chelsea,West Ham,1,1,D,2008-12-20,1,1,1,1,0,0,1,1,0
1308,2008-12-14,Portsmouth,Newcastle,0,3,A,2008-12-20,1,3,5,5,-4,-2,0,3,-3
1309,2008-12-20,Blackburn,Stoke,3,0,H,2008-12-20,3,0,0,0,3,0,3,0,3
1310,2008-12-20,Bolton,Portsmouth,2,1,H,2008-12-20,2,1,1,1,1,0,3,0,3
1311,2008-12-20,Fulham,Middlesbrough,3,0,H,2008-12-20,3,0,0,0,3,0,3,0,3
1312,2008-12-20,Hull,Sunderland,1,4,A,2008-12-20,1,4,4,4,-3,0,0,3,-3
1313,2008-12-20,West Ham,Aston Villa,0,1,A,2008-12-20,1,1,2,2,-1,-1,0,3,-3
1314,2008-12-21,Arsenal,Liverpool,1,1,D,2008-12-27,3,4,3,3,0,1,1,1,0
1315,2008-12-21,Newcastle,Tottenham,2,1,H,2008-12-27,3,1,3,3,0,-2,3,0,3
1316,2008-12-21,West Brom,Man City,2,1,H,2008-12-27,2,6,3,3,-1,3,3,0,3
1317,2008-12-22,Everton,Chelsea,0,0,D,2008-12-27,1,2,0,0,1,2,1,1,0
1318,2008-12-26,Aston Villa,Arsenal,2,2,D,2008-12-27,2,3,2,2,0,1,1,1,0
1319,2008-12-26,Chelsea,West Brom,2,0,H,2008-12-27,2,2,0,0,2,2,3,0,3
1320,2008-12-26,Liverpool,Bolton,3,0,H,2008-12-27,4,0,1,1,3,-1,3,0,3
1321,2008-12-26,Man City,Hull,5,1,H,2008-12-27,6,1,3,3,3,-2,3,0,3
1322,2008-12-26,Middlesbrough,Everton,0,1,A,2008-12-27,0,1,1,1,-1,0,0,3,-3
1323,2008-12-26,Portsmouth,West Ham,1,4,A,2008-12-27,1,4,4,4,-3,0,0,3,-3
1324,2008-12-26,Stoke,Man United,0,1,A,2008-12-27,0,1,1,1,-1,0,0,3,-3
1325,2008-12-26,Sunderland,Blackburn,0,0,D,2008-12-27,0,0,0,0,0,0,1,1,0
1326,2008-12-26,Tottenham,Fulham,0,0,D,2008-12-27,1,0,2,2,-1,-2,1,1,0
1327,2008-12-26,Wigan,Newcastle,2,1,H,2008-12-27,2,3,1,1,1,2,3,0,3
1328,2008-12-28,Arsenal,Portsmouth,1,0,H,2009-01-03,1,0,0,0,1,0,3,0,3
1329,2008-12-28,Blackburn,Man City,2,2,D,2009-01-03,2,2,2,2,0,0,1,1,0
1330,2008-12-28,Bolton,Wigan,0,1,A,2009-01-03,0,1,1,1,-1,0,0,3,-3
1331,2008-12-28,Everton,Sunderland,3,0,H,2009-01-03,3,0,0,0,3,0,3,0,3
1332,2008-12-28,Fulham,Chelsea,2,2,D,2009-01-03,2,2,2,2,0,0,1,1,0
1333,2008-12-28,Newcastle,Liverpool,1,5,A,2009-01-03,1,5,5,5,-4,0,0,3,-3
1334,2008-12-28,West Brom,Tottenham,2,0,H,2009-01-03,2,0,0,0,2,0,3,0,3
1335,2008-12-28,West Ham,Stoke,2,1,H,2009-01-03,2,1,1,1,1,0,3,0,3
1336,2008-12-29,Man United,Middlesbrough,1,0,H,2009-01-03,1,0,0,0,1,0,3,0,3
1337,2008-12-30,Hull,Aston Villa,0,1,A,2009-01-03,0,1,1,1,-1,0,0,3,-3
1338,2009-01-10,Arsenal,Bolton,1,0,H,2009-01-10,1,0,0,0,1,0,3,0,3
1339,2009-01-10,Aston Villa,West Brom,2,1,H,2009-01-10,2,1,1,1,1,0,3,0,3
1340,2009-01-10,Everton,Hull,2,0,H,2009-01-10,2,0,0,0,2,0,3,0,3
1341,2009-01-10,Middlesbrough,Sunderland,1,1,D,2009-01-10,1,1,1,1,0,0,1,1,0
1342,2009-01-10,Newcastle,West Ham,2,2,D,2009-01-10,2,2,2,2,0,0,1,1,0
1343,2009-01-10,Stoke,Liverpool,0,0,D,2009-01-10,0,0,0,0,0,0,1,1,0
1344,2009-01-11,Man United,Chelsea,3,0,H,2009-01-17,5,2,0,0,5,2,6,0,6
1345,2009-01-11,Wigan,Tottenham,1,0,H,2009-01-17,1,0,2,2,-1,-2,3,0,3
1346,2009-01-14,Man United,Wigan,1,0,H,2009-01-17,5,1,0,0,5,1,6,0,6
1347,2009-01-17,Blackburn,Newcastle,3,0,H,2009-01-17,3,0,0,0,3,0,3,0,3
1348,2009-01-17,Bolton,Man United,0,1,A,2009-01-17,0,5,1,1,-1,4,0,3,-3
1349,2009-01-17,Chelsea,Stoke,2,1,H,2009-01-17,2,1,4,4,-2,-3,3,0,3
1350,2009-01-17,Hull,Arsenal,1,3,A,2009-01-17,1,3,3,3,-2,0,0,3,-3
1351,2009-01-17,Man City,Wigan,1,0,H,2009-01-17,1,1,0,0,1,1,3,0,3
1352,2009-01-17,Sunderland,Aston Villa,1,2,A,2009-01-17,1,2,2,2,-1,0,0,3,-3
1353,2009-01-17,West Brom,Middlesbrough,3,0,H,2009-01-17,3,0,0,0,3,0,3,0,3
1354,2009-01-18,Tottenham,Portsmouth,1,1,D,2009-01-24,1,1,1,1,0,0,1,1,0
1355,2009-01-18,West Ham,Fulham,3,1,H,2009-01-24,3,1,1,1,2,0,3,0,3
1356,2009-01-19,Liverpool,Everton,1,1,D,2009-01-24,1,1,1,1,0,0,1,1,0
1357,2009-01-27,Portsmouth,Aston Villa,0,1,A,2009-01-31,1,1,4,4,-3,-3,0,3,-3
1358,2009-01-27,Sunderland,Fulham,1,0,H,2009-01-31,1,3,0,0,1,3,3,0,3
1359,2009-01-27,Tottenham,Stoke,3,1,H,2009-01-31,5,2,4,4,1,-2,3,0,3
1360,2009-01-27,West Brom,Man United,0,5,A,2009-01-31,2,6,7,7,-5,-1,0,3,-3
1361,2009-01-28,Blackburn,Bolton,2,2,D,2009-01-31,2,5,2,2,0,3,1,1,0
1362,2009-01-28,Chelsea,Middlesbrough,2,0,H,2009-01-31,2,0,0,0,2,0,3,0,3
1363,2009-01-28,Everton,Arsenal,1,1,D,2009-01-31,1,1,2,2,-1,-1,1,1,0
1364,2009-01-28,Man City,Newcastle,2,1,H,2009-01-31,2,1,2,2,0,-1,3,0,3
1365,2009-01-28,West Ham,Hull,2,0,H,2009-01-31,2,2,0,0,2,2,3,0,3
1366,2009-01-28,Wigan,Liverpool,1,1,D,2009-01-31,1,1,1,1,0,0,1,1,0
1367,2009-01-31,Arsenal,West Ham,0,0,D,2009-01-31,1,2,1,1,0,1,1,1,0
1368,2009-01-31,Aston Villa,Wigan,0,0,D,2009-01-31,1,1,0,0,1,1,1,1,0
1369,2009-01-31,Bolton,Tottenham,3,2,H,2009-01-31,5,5,4,4,1,1,3,0,3
1370,2009-01-31,Fulham,Portsmouth,3,1,H,2009-01-31,3,1,2,2,1,-1,3,0,3
1371,2009-01-31,Hull,West Brom,2,2,D,2009-01-31,2,2,4,4,-2,-2,1,1,0
1372,2009-01-31,Man United,Everton,1,0,H,2009-01-31,6,1,0,0,6,1,3,0,3
1373,2009-01-31,Middlesbrough,Blackburn,0,0,D,2009-01-31,0,2,2,2,-2,0,1,1,0
1374,2009-01-31,Stoke,Man City,1,0,H,2009-01-31,2,2,3,3,-1,-1,3,0,3
1375,2009-02-01,Liverpool,Chelsea,2,0,H,2009-02-07,5,0,2,2,3,-2,3,0,3
1376,2009-02-01,Newcastle,Sunderland,1,1,D,2009-02-07,4,3,3,3,1,0,1,1,0
1377,2009-02-07,Blackburn,Aston Villa,0,2,A,2009-02-07,0,2,2,2,-2,0,0,3,-3
1378,2009-02-07,Chelsea,Hull,0,0,D,2009-02-07,0,0,2,2,-2,-2,1,1,0
1379,2009-02-07,Everton,Bolton,3,0,H,2009-02-07,3,0,0,0,3,0,3,0,3
1380,2009-02-07,Man City,Middlesbrough,1,0,H,2009-02-07,1,0,0,0,1,0,3,0,3
1381,2009-02-07,Portsmouth,Liverpool,2,3,A,2009-02-07,2,5,3,3,-1,2,0,3,-3
1382,2009-02-07,Sunderland,Stoke,2,0,H,2009-02-07,3,0,1,1,2,-1,3,0,3
1383,2009-02-07,West Brom,Newcastle,2,3,A,2009-02-07,2,4,3,3,-1,1,0,3,-3
1384,2009-02-07,Wigan,Fulham,0,0,D,2009-02-07,0,0,0,0,0,0,1,1,0
1385,2009-02-08,Tottenham,Arsenal,0,0,D,2009-02-14,0,0,0,0,0,0,1,1,0
1386,2009-02-08,West Ham,Man United,0,1,A,2009-02-14,0,1,1,1,-1,0,0,3,-3
1387,2009-02-14,Portsmouth,Man City,2,0,H,2009-02-14,2,0,0,0,2,0,3,0,3
1388,2009-02-18,Man United,Fulham,3,0,H,2009-02-21,5,0,1,1,4,-1,6,0,6
1389,2009-02-21,Arsenal,Sunderland,0,0,D,2009-02-21,0,0,0,0,0,0,1,1,0
1390,2009-02-21,Aston Villa,Chelsea,0,1,A,2009-02-21,0,1,1,1,-1,0,0,3,-3
1391,2009-02-21,Bolton,West Ham,2,1,H,2009-02-21,2,1,1,1,1,0,3,0,3
1392,2009-02-21,Man United,Blackburn,2,1,H,2009-02-21,5,1,1,1,4,0,6,0,6
1393,2009-02-21,Middlesbrough,Wigan,0,0,D,2009-02-21,0,0,0,0,0,0,1,1,0
1394,2009-02-21,Stoke,Portsmouth,2,2,D,2009-02-21,2,2,2,2,0,0,1,1,0
1395,2009-02-22,Fulham,West Brom,2,0,H,2009-02-28,2,0,0,0,2,0,3,0,3
1396,2009-02-22,Liverpool,Man City,1,1,D,2009-02-28,1,1,3,3,-2,-2,1,1,0
1397,2009-02-22,Newcastle,Everton,0,0,D,2009-02-28,0,2,0,0,0,2,1,1,0
1398,2009-02-23,Hull,Tottenham,1,2,A,2009-02-28,1,2,2,2,-1,0,0,3,-3
1399,2009-02-28,Arsenal,Fulham,0,0,D,2009-02-28,0,2,0,0,0,2,1,1,0
1400,2009-02-28,Chelsea,Wigan,2,1,H,2009-02-28,2,1,1,1,1,0,3,0,3
1401,2009-02-28,Everton,West Brom,2,0,H,2009-02-28,2,0,0,0,2,0,3,0,3
1402,2009-02-28,Middlesbrough,Liverpool,2,0,H,2009-02-28,2,1,0,0,2,1,3,0,3
1403,2009-03-01,Aston Villa,Stoke,2,2,D,2009-03-07,2,4,4,4,-2,0,1,1,0
1404,2009-03-01,Bolton,Newcastle,1,0,H,2009-03-07,1,1,2,2,-1,-1,3,0,3
1405,2009-03-01,Hull,Blackburn,1,2,A,2009-03-07,2,2,2,2,0,0,0,3,-3
1406,2009-03-01,West Ham,Man City,1,0,H,2009-03-07,2,2,0,0,2,2,3,0,3
1407,2009-03-03,Liverpool,Sunderland,2,0,H,2009-03-07,2,1,0,0,2,1,3,0,3
1408,2009-03-03,Portsmouth,Chelsea,0,1,A,2009-03-07,0,1,1,1,-1,0,0,3,-3
1409,2009-03-03,West Brom,Arsenal,1,3,A,2009-03-07,1,3,3,3,-2,0,0,3,-3
1410,2009-03-04,Blackburn,Everton,0,0,D,2009-03-07,2,0,1,1,1,-1,1,1,0
1411,2009-03-04,Fulham,Hull,0,1,A,2009-03-07,0,2,1,1,-1,1,0,3,-3
1412,2009-03-04,Man City,Aston Villa,2,0,H,2009-03-07,2,2,1,1,1,1,3,0,3
1413,2009-03-04,Newcastle,Man United,1,2,A,2009-03-07,1,2,3,3,-2,-1,0,3,-3
1414,2009-03-04,Stoke,Bolton,2,0,H,2009-03-07,4,1,2,2,2,-1,3,0,3
1415,2009-03-04,Tottenham,Middlesbrough,4,0,H,2009-03-07,5,0,1,1,4,-1,3,0,3
1416,2009-03-04,Wigan,West Ham,0,1,A,2009-03-07,0,2,1,1,-1,1,0,3,-3
1417,2009-03-07,Sunderland,Tottenham,1,1,D,2009-03-07,1,5,3,3,-2,2,1,1,0
1418,2009-03-11,Fulham,Blackburn,1,2,A,2009-03-14,4,2,3,3,1,-1,0,3,-3
1419,2009-03-14,Arsenal,Blackburn,4,0,H,2009-03-14,4,2,0,0,4,2,3,3,0
1420,2009-03-14,Bolton,Fulham,1,3,A,2009-03-14,1,4,3,3,-2,1,0,3,-3
1421,2009-03-14,Everton,Stoke,3,1,H,2009-03-14,3,1,1,1,2,0,3,0,3
1422,2009-03-14,Hull,Newcastle,1,1,D,2009-03-14,1,1,1,1,0,0,1,1,0
1423,2009-03-14,Man United,Liverpool,1,4,A,2009-03-14,1,4,4,4,-3,0,0,3,-3
1424,2009-03-14,Middlesbrough,Portsmouth,1,1,D,2009-03-14,1,1,1,1,0,0,1,1,0
1425,2009-03-14,Sunderland,Wigan,1,2,A,2009-03-14,1,2,2,2,-1,0,0,3,-3
1426,2009-03-15,Aston Villa,Tottenham,1,2,A,2009-03-21,1,3,2,2,-1,1,0,3,-3
1427,2009-03-15,Chelsea,Man City,1,0,H,2009-03-21,1,0,1,1,0,-1,3,0,3
1428,2009-03-16,West Ham,West Brom,0,0,D,2009-03-21,1,1,1,1,0,0,1,1,0
1429,2009-03-21,Blackburn,West Ham,1,1,D,2009-03-21,1,1,1,1,0,0,1,1,0
1430,2009-03-21,Fulham,Man United,2,0,H,2009-03-21,2,0,0,0,2,0,3,0,3
1431,2009-03-21,Newcastle,Arsenal,1,3,A,2009-03-21,1,3,3,3,-2,0,0,3,-3
1432,2009-03-21,Portsmouth,Everton,2,1,H,2009-03-21,2,1,1,1,1,0,3,0,3
1433,2009-03-21,Stoke,Middlesbrough,1,0,H,2009-03-21,1,0,0,0,1,0,3,0,3
1434,2009-03-21,Tottenham,Chelsea,1,0,H,2009-03-21,3,1,1,1,2,0,3,0,3
1435,2009-03-21,West Brom,Bolton,1,1,D,2009-03-21,1,1,1,1,0,0,1,1,0
1436,2009-03-22,Liverpool,Aston Villa,5,0,H,2009-03-28,5,0,0,0,5,0,3,0,3
1437,2009-03-22,Man City,Sunderland,1,0,H,2009-03-28,1,0,0,0,1,0,3,0,3
1438,2009-03-22,Wigan,Hull,1,0,H,2009-03-28,1,0,0,0,1,0,3,0,3
1439,2009-04-04,Arsenal,Man City,2,0,H,2009-04-04,2,0,0,0,2,0,3,0,3
1440,2009-04-04,Blackburn,Tottenham,2,1,H,2009-04-04,2,1,1,1,1,0,3,0,3
1441,2009-04-04,Bolton,Middlesbrough,4,1,H,2009-04-04,4,1,1,1,3,0,3,0,3
1442,2009-04-04,Fulham,Liverpool,0,1,A,2009-04-04,0,1,1,1,-1,0,0,3,-3
1443,2009-04-04,Hull,Portsmouth,0,0,D,2009-04-04,0,0,0,0,0,0,1,1,0
1444,2009-04-04,Newcastle,Chelsea,0,2,A,2009-04-04,0,2,2,2,-2,0,0,3,-3
1445,2009-04-04,West Brom,Stoke,0,2,A,2009-04-04,0,2,2,2,-2,0,0,3,-3
1446,2009-04-04,West Ham,Sunderland,2,0,H,2009-04-04,2,0,0,0,2,0,3,0,3
1447,2009-04-05,Everton,Wigan,4,0,H,2009-04-11,4,1,0,0,4,1,3,0,3
1448,2009-04-05,Man United,Aston Villa,3,2,H,2009-04-11,5,2,3,3,2,-1,3,0,3
1449,2009-04-11,Chelsea,Bolton,4,3,H,2009-04-11,4,3,3,3,1,0,3,0,3
1450,2009-04-11,Liverpool,Blackburn,4,0,H,2009-04-11,4,0,0,0,4,0,3,0,3
1451,2009-04-11,Middlesbrough,Hull,3,1,H,2009-04-11,3,1,1,1,2,0,3,0,3
1452,2009-04-11,Portsmouth,West Brom,2,2,D,2009-04-11,2,2,2,2,0,0,1,1,0
1453,2009-04-11,Stoke,Newcastle,1,1,D,2009-04-11,1,1,1,1,0,0,1,1,0
1454,2009-04-11,Sunderland,Man United,1,2,A,2009-04-11,1,5,2,2,-1,3,0,3,-3
1455,2009-04-11,Tottenham,West Ham,1,0,H,2009-04-11,1,0,0,0,1,0,3,0,3
1456,2009-04-11,Wigan,Arsenal,1,4,A,2009-04-11,1,4,8,8,-7,-4,0,3,-3
1457,2009-04-12,Aston Villa,Everton,3,3,D,2009-04-18,4,3,4,4,0,-1,2,1,1
1458,2009-04-12,Man City,Fulham,1,3,A,2009-04-18,1,3,3,3,-2,0,0,4,-4
1459,2009-04-18,Aston Villa,West Ham,1,1,D,2009-04-18,4,1,4,4,0,-3,2,1,1
1460,2009-04-18,Middlesbrough,Fulham,0,0,D,2009-04-18,0,3,0,0,0,3,1,4,-3
1461,2009-04-18,Portsmouth,Bolton,1,0,H,2009-04-18,1,0,0,0,1,0,3,0,3
1462,2009-04-18,Stoke,Blackburn,1,0,H,2009-04-18,1,0,0,0,1,0,3,0,3
1463,2009-04-18,Sunderland,Hull,1,0,H,2009-04-18,1,0,0,0,1,0,3,0,3
1464,2009-04-19,Man City,West Brom,4,2,H,2009-04-25,6,5,3,3,3,2,3,0,3
1465,2009-04-19,Tottenham,Newcastle,1,0,H,2009-04-25,3,0,5,5,-2,-5,3,0,3
1466,2009-04-21,Liverpool,Arsenal,4,4,D,2009-04-25,7,4,5,5,2,-1,1,1,0
1467,2009-04-22,Chelsea,Everton,0,0,D,2009-04-25,1,1,0,0,1,1,1,1,0
1468,2009-04-22,Man United,Portsmouth,2,0,H,2009-04-25,7,0,2,2,5,-2,6,0,6
1469,2009-04-25,Bolton,Aston Villa,1,1,D,2009-04-25,1,1,1,1,0,0,1,1,0
1470,2009-04-25,Everton,Man City,1,2,A,2009-04-25,1,6,2,2,-1,4,0,3,-3
1471,2009-04-25,Fulham,Stoke,1,0,H,2009-04-25,1,0,0,0,1,0,3,0,3
1472,2009-04-25,Hull,Liverpool,1,3,A,2009-04-25,1,7,3,3,-2,4,0,3,-3
1473,2009-04-25,Man United,Tottenham,5,2,H,2009-04-25,7,3,2,2,5,1,6,0,6
1474,2009-04-25,West Brom,Sunderland,3,0,H,2009-04-25,5,0,4,4,1,-4,3,0,3
1475,2009-04-25,West Ham,Chelsea,0,1,A,2009-04-25,0,1,1,1,-1,0,0,3,-3
1476,2009-04-26,Arsenal,Middlesbrough,2,0,H,2009-05-02,5,0,0,0,5,0,3,0,3
1477,2009-04-26,Blackburn,Wigan,2,0,H,2009-05-02,3,0,3,3,0,-3,3,0,3
1478,2009-04-27,Newcastle,Portsmouth,0,0,D,2009-05-02,0,0,0,0,0,0,1,1,0
1479,2009-05-02,Chelsea,Fulham,3,1,H,2009-05-02,3,1,1,1,2,0,3,0,3
1480,2009-05-02,Man City,Blackburn,3,1,H,2009-05-02,3,3,1,1,2,2,3,0,3
1481,2009-05-02,Middlesbrough,Man United,0,2,A,2009-05-02,0,2,4,4,-4,-2,0,3,-3
1482,2009-05-02,Portsmouth,Arsenal,0,3,A,2009-05-02,0,5,3,3,-3,2,0,3,-3
1483,2009-05-02,Stoke,West Ham,0,1,A,2009-05-02,0,1,1,1,-1,0,0,3,-3
1484,2009-05-02,Tottenham,West Brom,1,0,H,2009-05-02,1,0,0,0,1,0,3,0,3
1485,2009-05-02,Wigan,Bolton,0,0,D,2009-05-02,0,0,2,2,-2,-2,1,1,0
1486,2009-05-03,Liverpool,Newcastle,3,0,H,2009-05-09,6,0,0,0,6,0,3,0,3
1487,2009-05-03,Sunderland,Everton,0,2,A,2009-05-09,0,2,2,2,-2,0,0,3,-3
1488,2009-05-04,Aston Villa,Hull,1,0,H,2009-05-09,2,1,3,3,-1,-2,3,0,3
1489,2009-05-09,Blackburn,Portsmouth,2,0,H,2009-05-09,2,0,0,0,2,0,3,0,3
1490,2009-05-09,Bolton,Sunderland,0,0,D,2009-05-09,0,0,0,0,0,0,1,1,0
1491,2009-05-09,Everton,Tottenham,0,0,D,2009-05-09,2,0,0,0,2,0,1,1,0
1492,2009-05-09,Fulham,Aston Villa,3,1,H,2009-05-09,3,2,1,1,2,1,3,0,3
1493,2009-05-09,Hull,Stoke,1,2,A,2009-05-09,1,2,3,3,-2,-1,0,3,-3
1494,2009-05-09,West Brom,Wigan,3,1,H,2009-05-09,3,1,1,1,2,0,3,0,3
1495,2009-05-09,West Ham,Liverpool,0,3,A,2009-05-09,0,6,3,3,-3,3,0,3,-3
1496,2009-05-10,Arsenal,Chelsea,1,4,A,2009-05-16,1,4,4,4,-3,0,0,3,-3
1497,2009-05-10,Man United,Man City,2,0,H,2009-05-16,4,1,1,1,3,0,4,0,4
1498,2009-05-11,Newcastle,Middlesbrough,3,1,H,2009-05-16,3,2,2,2,1,0,3,0,3
1499,2009-05-13,Wigan,Man United,1,2,A,2009-05-16,1,4,4,4,-3,0,0,3,-3
1500,2009-05-16,Bolton,Hull,1,1,D,2009-05-16,1,1,1,1,0,0,1,1,0
1501,2009-05-16,Everton,West Ham,3,1,H,2009-05-16,3,1,1,1,2,0,3,0,3
1502,2009-05-16,Man United,Arsenal,0,0,D,2009-05-16,4,1,1,1,3,0,4,1,3
1503,2009-05-16,Middlesbrough,Aston Villa,1,1,D,2009-05-16,2,1,4,4,-2,-3,1,1,0
1504,2009-05-16,Newcastle,Fulham,0,1,A,2009-05-16,3,1,2,2,1,-1,3,3,0
1505,2009-05-16,Stoke,Wigan,2,0,H,2009-05-16,2,1,0,0,2,1,3,0,3
1506,2009-05-16,Tottenham,Man City,2,1,H,2009-05-16,2,1,1,1,1,0,3,0,3
1507,2009-05-17,Chelsea,Blackburn,2,0,H,2009-05-23,2,0,0,0,2,0,3,0,3
1508,2009-05-17,West Brom,Liverpool,0,2,A,2009-05-23,0,2,2,2,-2,0,0,3,-3
1509,2009-05-24,Arsenal,Stoke,4,1,H,2009-05-30,4,1,1,1,3,0,3,0,3
1510,2009-05-24,Aston Villa,Newcastle,1,0,H,2009-05-30,1,0,0,0,1,0,3,0,3
1511,2009-05-24,Blackburn,West Brom,0,0,D,2009-05-30,0,0,0,0,0,0,1,1,0
1512,2009-05-24,Fulham,Everton,0,2,A,2009-05-30,0,2,2,2,-2,0,0,3,-3
1513,2009-05-24,Hull,Man United,0,1,A,2009-05-30,0,1,1,1,-1,0,0,3,-3
1514,2009-05-24,Liverpool,Tottenham,3,1,H,2009-05-30,3,1,1,1,2,0,3,0,3
1515,2009-05-24,Man City,Bolton,1,0,H,2009-05-30,1,0,0,0,1,0,3,0,3
1516,2009-05-24,Sunderland,Chelsea,2,3,A,2009-05-30,2,3,3,3,-1,0,0,3,-3
1517,2009-05-24,West Ham,Middlesbrough,2,1,H,2009-05-30,2,1,1,1,1,0,3,0,3
1518,2009-05-24,Wigan,Portsmouth,1,0,H,2009-05-30,1,0,0,0,1,0,3,0,3
1519,2009-08-15,Aston Villa,Wigan,0,2,A,2009-08-15,0,2,2,2,-2,0,0,3,-3
1520,2009-08-15,Blackburn,Man City,0,2,A,2009-08-15,0,2,2,2,-2,0,0,3,-3
1521,2009-08-15,Bolton,Sunderland,0,1,A,2009-08-15,0,1,1,1,-1,0,0,3,-3
1522,2009-08-15,Chelsea,Hull,2,1,H,2009-08-15,2,1,1,1,1,0,3,0,3
1523,2009-08-15,Everton,Arsenal,1,6,A,2009-08-15,1,6,6,6,-5,0,0,3,-3
1524,2009-08-15,Portsmouth,Fulham,0,1,A,2009-08-15,0,1,1,1,-1,0,0,3,-3
1525,2009-08-15,Stoke,Burnley,2,0,H,2009-08-15,2,0,0,0,2,0,3,0,3
1526,2009-08-15,Wolves,West Ham,0,2,A,2009-08-15,0,2,2,2,-2,0,0,3,-3
1527,2009-08-16,Man United,Birmingham,1,0,H,2009-08-22,6,1,1,1,5,0,3,0,3
1528,2009-08-16,Tottenham,Liverpool,2,1,H,2009-08-22,7,5,2,2,5,3,3,0,3
1529,2009-08-18,Sunderland,Chelsea,1,3,A,2009-08-22,3,3,4,4,-1,-1,3,3,0
1530,2009-08-18,Wigan,Wolves,0,1,A,2009-08-22,0,1,6,6,-6,-5,0,3,-3
1531,2009-08-19,Birmingham,Portsmouth,1,0,H,2009-08-22,1,1,1,1,0,0,4,0,4
1532,2009-08-19,Burnley,Man United,1,0,H,2009-08-22,1,6,0,0,1,6,3,3,0
1533,2009-08-19,Hull,Tottenham,1,5,A,2009-08-22,2,7,5,5,-3,2,3,3,0
1534,2009-08-19,Liverpool,Stoke,4,0,H,2009-08-22,5,0,2,2,3,-2,3,1,2
1535,2009-08-22,Arsenal,Portsmouth,4,1,H,2009-08-22,4,1,1,1,3,0,3,0,3
1536,2009-08-22,Birmingham,Stoke,0,0,D,2009-08-22,1,0,1,1,0,-1,4,1,3
1537,2009-08-22,Hull,Bolton,1,0,H,2009-08-22,2,0,5,5,-3,-5,3,0,3
1538,2009-08-22,Man City,Wolves,1,0,H,2009-08-22,1,1,0,0,1,1,3,3,0
1539,2009-08-22,Sunderland,Blackburn,2,1,H,2009-08-22,3,1,4,4,-1,-3,3,0,3
1540,2009-08-22,Wigan,Man United,0,5,A,2009-08-22,0,6,6,6,-6,0,0,3,-3
1541,2009-08-23,Burnley,Everton,1,0,H,2009-08-29,1,0,3,3,-2,-3,3,0,3
1542,2009-08-23,Fulham,Chelsea,0,2,A,2009-08-29,0,5,2,2,-2,3,0,3,-3
1543,2009-08-23,West Ham,Tottenham,1,2,A,2009-08-29,1,4,2,2,-1,2,0,3,-3
1544,2009-08-24,Liverpool,Aston Villa,1,3,A,2009-08-29,4,3,5,5,-1,-2,0,3,-3
1545,2009-08-29,Blackburn,West Ham,0,0,D,2009-08-29,0,1,0,0,0,1,1,1,0
1546,2009-08-29,Bolton,Liverpool,2,3,A,2009-08-29,2,4,3,3,-1,1,0,3,-3
1547,2009-08-29,Chelsea,Burnley,3,0,H,2009-08-29,5,1,0,0,5,1,3,0,3
1548,2009-08-29,Man United,Arsenal,2,1,H,2009-08-29,2,1,1,1,1,0,3,0,3
1549,2009-08-29,Stoke,Sunderland,1,0,H,2009-08-29,1,0,0,0,1,0,3,0,3
1550,2009-08-29,Tottenham,Birmingham,2,1,H,2009-08-29,4,1,2,2,2,-1,3,0,3
1551,2009-08-29,Wolves,Hull,1,1,D,2009-08-29,1,1,1,1,0,0,1,1,0
1552,2009-08-30,Aston Villa,Fulham,2,0,H,2009-09-05,2,0,0,0,2,0,3,0,3
1553,2009-08-30,Everton,Wigan,2,1,H,2009-09-05,2,1,1,1,1,0,3,0,3
1554,2009-08-30,Portsmouth,Man City,0,1,A,2009-09-05,0,1,1,1,-1,0,0,3,-3
1555,2009-09-12,Blackburn,Wolves,3,1,H,2009-09-12,3,1,1,1,2,0,3,0,3
1556,2009-09-12,Liverpool,Burnley,4,0,H,2009-09-12,4,0,0,0,4,0,3,0,3
1557,2009-09-12,Man City,Arsenal,4,2,H,2009-09-12,4,2,2,2,2,0,3,0,3
1558,2009-09-12,Portsmouth,Bolton,2,3,A,2009-09-12,2,3,3,3,-1,0,0,3,-3
1559,2009-09-12,Stoke,Chelsea,1,2,A,2009-09-12,1,2,2,2,-1,0,0,3,-3
1560,2009-09-12,Sunderland,Hull,4,1,H,2009-09-12,4,1,1,1,3,0,3,0,3
1561,2009-09-12,Tottenham,Man United,1,3,A,2009-09-12,1,3,3,3,-2,0,0,3,-3
1562,2009-09-12,Wigan,West Ham,1,0,H,2009-09-12,1,0,0,0,1,0,3,0,3
1563,2009-09-13,Birmingham,Aston Villa,0,1,A,2009-09-19,1,3,1,1,0,2,0,3,-3
1564,2009-09-13,Fulham,Everton,2,1,H,2009-09-19,2,1,1,1,1,0,3,0,3
1565,2009-09-19,Arsenal,Wigan,4,0,H,2009-09-19,4,0,0,0,4,0,3,0,3
1566,2009-09-19,Aston Villa,Portsmouth,2,0,H,2009-09-19,3,0,0,0,3,0,3,0,3
1567,2009-09-19,Bolton,Stoke,1,1,D,2009-09-19,1,1,1,1,0,0,1,1,0
1568,2009-09-19,Burnley,Sunderland,3,1,H,2009-09-19,3,1,1,1,2,0,3,0,3
1569,2009-09-19,Hull,Birmingham,0,1,A,2009-09-19,0,1,1,1,-1,0,0,3,-3
1570,2009-09-19,West Ham,Liverpool,2,3,A,2009-09-19,2,3,3,3,-1,0,0,3,-3
1571,2009-09-20,Chelsea,Tottenham,3,0,H,2009-09-26,4,5,3,3,1,2,3,0,3
1572,2009-09-20,Everton,Blackburn,3,0,H,2009-09-26,4,2,0,0,4,2,3,0,3
1573,2009-09-20,Man United,Man City,4,3,H,2009-09-26,6,3,3,3,3,0,3,0,3
1574,2009-09-20,Wolves,Fulham,2,1,H,2009-09-26,2,1,1,1,1,0,3,0,3
1575,2009-09-26,Birmingham,Bolton,1,2,A,2009-09-26,1,2,2,2,-1,0,0,3,-3
1576,2009-09-26,Blackburn,Aston Villa,2,1,H,2009-09-26,2,1,4,4,-2,-3,3,0,3
1577,2009-09-26,Fulham,Arsenal,0,1,A,2009-09-26,1,1,3,3,-2,-2,0,3,-3
1578,2009-09-26,Liverpool,Hull,6,1,H,2009-09-26,6,1,1,1,5,0,3,0,3
1579,2009-09-26,Portsmouth,Everton,0,1,A,2009-09-26,0,4,1,1,-1,3,0,3,-3
1580,2009-09-26,Stoke,Man United,0,2,A,2009-09-26,0,6,2,2,-2,4,0,3,-3
1581,2009-09-26,Tottenham,Burnley,5,0,H,2009-09-26,5,0,3,3,2,-3,3,0,3
1582,2009-09-26,Wigan,Chelsea,3,1,H,2009-09-26,3,4,1,1,2,3,3,0,3
1583,2009-09-27,Sunderland,Wolves,5,2,H,2009-10-03,7,2,4,4,3,-2,3,0,3
1584,2009-09-28,Man City,West Ham,3,1,H,2009-10-03,3,1,1,1,2,0,3,0,3
1585,2009-10-03,Bolton,Tottenham,2,2,D,2009-10-03,2,2,2,2,0,0,1,1,0
1586,2009-10-03,Burnley,Birmingham,2,1,H,2009-10-03,2,1,1,1,1,0,3,0,3
1587,2009-10-03,Hull,Wigan,2,1,H,2009-10-03,2,1,1,1,1,0,3,0,3
1588,2009-10-03,Man United,Sunderland,2,2,D,2009-10-03,2,7,2,2,0,5,1,1,0
1589,2009-10-03,Wolves,Portsmouth,0,1,A,2009-10-03,2,1,6,6,-4,-5,0,3,-3
1590,2009-10-04,Arsenal,Blackburn,6,2,H,2009-10-10,6,2,2,2,4,0,3,0,3
1591,2009-10-04,Chelsea,Liverpool,2,0,H,2009-10-10,2,0,0,0,2,0,3,0,3
1592,2009-10-04,Everton,Stoke,1,1,D,2009-10-10,1,1,1,1,0,0,1,1,0
1593,2009-10-04,West Ham,Fulham,2,2,D,2009-10-10,2,2,2,2,0,0,1,1,0
1594,2009-10-05,Aston Villa,Man City,1,1,D,2009-10-10,1,1,1,1,0,0,1,1,0
1595,2009-10-17,Arsenal,Birmingham,3,1,H,2009-10-17,3,1,1,1,2,0,3,0,3
1596,2009-10-17,Aston Villa,Chelsea,2,1,H,2009-10-17,2,1,1,1,1,0,3,0,3
1597,2009-10-17,Everton,Wolves,1,1,D,2009-10-17,1,1,1,1,0,0,1,1,0
1598,2009-10-17,Man United,Bolton,2,1,H,2009-10-17,2,1,1,1,1,0,3,0,3
1599,2009-10-17,Portsmouth,Tottenham,1,2,A,2009-10-17,1,2,2,2,-1,0,0,3,-3
1600,2009-10-17,Stoke,West Ham,2,1,H,2009-10-17,2,1,1,1,1,0,3,0,3
1601,2009-10-17,Sunderland,Liverpool,1,0,H,2009-10-17,1,0,0,0,1,0,3,0,3
1602,2009-10-18,Blackburn,Burnley,3,2,H,2009-10-24,3,3,7,7,-4,-4,3,0,3
1603,2009-10-18,Wigan,Man City,1,1,D,2009-10-24,4,1,2,2,2,-1,1,1,0
1604,2009-10-19,Fulham,Hull,2,0,H,2009-10-24,2,0,0,0,2,0,3,0,3
1605,2009-10-24,Birmingham,Sunderland,2,1,H,2009-10-24,2,1,1,1,1,0,3,0,3
1606,2009-10-24,Burnley,Wigan,1,3,A,2009-10-24,3,4,6,6,-3,-2,0,3,-3
1607,2009-10-24,Chelsea,Blackburn,5,0,H,2009-10-24,5,3,0,0,5,3,3,0,3
1608,2009-10-24,Hull,Portsmouth,0,0,D,2009-10-24,0,0,2,2,-2,-2,1,1,0
1609,2009-10-24,Tottenham,Stoke,0,1,A,2009-10-24,0,1,1,1,-1,0,0,3,-3
1610,2009-10-24,Wolves,Aston Villa,1,1,D,2009-10-24,1,1,1,1,0,0,1,1,0
1611,2009-10-25,Bolton,Everton,3,2,H,2009-10-31,3,3,6,6,-3,-3,3,0,3
1612,2009-10-25,Liverpool,Man United,2,0,H,2009-10-31,3,2,3,3,0,-1,3,0,3
1613,2009-10-25,Man City,Fulham,2,2,D,2009-10-31,2,5,2,2,0,3,1,1,0
1614,2009-10-25,West Ham,Arsenal,2,2,D,2009-10-31,4,5,4,4,0,1,1,1,0
1615,2009-10-31,Arsenal,Tottenham,3,0,H,2009-10-31,5,0,2,2,3,-2,3,0,3
1616,2009-10-31,Bolton,Chelsea,0,4,A,2009-10-31,3,4,6,6,-3,-2,3,3,0
1617,2009-10-31,Burnley,Hull,2,0,H,2009-10-31,2,0,0,0,2,0,3,0,3
1618,2009-10-31,Everton,Aston Villa,1,1,D,2009-10-31,3,1,4,4,-1,-3,1,1,0
1619,2009-10-31,Fulham,Liverpool,3,1,H,2009-10-31,5,3,3,3,2,0,3,0,3
1620,2009-10-31,Man United,Blackburn,2,0,H,2009-10-31,2,0,2,2,0,-2,3,0,3
1621,2009-10-31,Portsmouth,Wigan,4,0,H,2009-10-31,4,0,0,0,4,0,3,0,3
1622,2009-10-31,Stoke,Wolves,2,2,D,2009-10-31,2,2,2,2,0,0,1,1,0
1623,2009-10-31,Sunderland,West Ham,2,2,D,2009-10-31,2,4,2,2,0,2,1,1,0
1624,2009-11-01,Birmingham,Man City,0,0,D,2009-11-07,0,3,0,0,0,3,1,1,0
1625,2009-11-04,West Ham,Aston Villa,2,1,H,2009-11-07,2,6,1,1,1,5,3,0,3
1626,2009-11-07,Aston Villa,Bolton,5,1,H,2009-11-07,6,1,3,3,3,-2,3,0,3
1627,2009-11-07,Blackburn,Portsmouth,3,1,H,2009-11-07,3,1,1,1,2,0,3,0,3
1628,2009-11-07,Man City,Burnley,3,3,D,2009-11-07,3,3,3,3,0,0,1,1,0
1629,2009-11-07,Tottenham,Sunderland,2,0,H,2009-11-07,2,0,0,0,2,0,3,0,3
1630,2009-11-07,Wolves,Arsenal,1,4,A,2009-11-07,1,4,4,4,-3,0,0,3,-3
1631,2009-11-08,Chelsea,Man United,1,0,H,2009-11-14,1,0,0,0,1,0,3,0,3
1632,2009-11-08,Hull,Stoke,2,1,H,2009-11-14,2,1,1,1,1,0,3,0,3
1633,2009-11-08,West Ham,Everton,1,2,A,2009-11-14,1,2,2,2,-1,0,0,3,-3
1634,2009-11-08,Wigan,Fulham,1,1,D,2009-11-14,1,1,1,1,0,0,1,1,0
1635,2009-11-09,Liverpool,Birmingham,2,2,D,2009-11-14,2,2,2,2,0,0,1,1,0
1636,2009-11-21,Birmingham,Fulham,1,0,H,2009-11-21,1,0,0,0,1,0,3,0,3
1637,2009-11-21,Burnley,Aston Villa,1,1,D,2009-11-21,1,1,1,1,0,0,1,1,0
1638,2009-11-21,Chelsea,Wolves,4,0,H,2009-11-21,4,0,0,0,4,0,3,0,3
1639,2009-11-21,Hull,West Ham,3,3,D,2009-11-21,3,3,3,3,0,0,1,1,0
1640,2009-11-21,Liverpool,Man City,2,2,D,2009-11-21,2,2,2,2,0,0,1,1,0
1641,2009-11-21,Man United,Everton,3,0,H,2009-11-21,3,0,0,0,3,0,3,0,3
1642,2009-11-21,Sunderland,Arsenal,1,0,H,2009-11-21,1,0,0,0,1,0,3,0,3
1643,2009-11-22,Bolton,Blackburn,0,2,A,2009-11-28,1,2,3,3,-2,-1,0,3,-3
1644,2009-11-22,Stoke,Portsmouth,1,0,H,2009-11-28,1,1,0,0,1,1,3,0,3
1645,2009-11-22,Tottenham,Wigan,9,1,H,2009-11-28,10,2,2,2,8,0,3,0,3
1646,2009-11-25,Fulham,Blackburn,3,0,H,2009-11-28,4,2,1,1,3,1,4,3,1
1647,2009-11-25,Hull,Everton,3,2,H,2009-11-28,4,2,3,3,1,-1,3,0,3
1648,2009-11-28,Aston Villa,Tottenham,1,1,D,2009-11-28,1,10,1,1,0,9,1,1,0
1649,2009-11-28,Blackburn,Stoke,0,0,D,2009-11-28,2,1,3,3,-1,-2,1,1,0
1650,2009-11-28,Fulham,Bolton,1,1,D,2009-11-28,4,1,1,1,3,0,4,1,3
1651,2009-11-28,Man City,Hull,1,1,D,2009-11-28,1,4,1,1,0,3,1,1,0
1652,2009-11-28,Portsmouth,Man United,1,4,A,2009-11-28,1,4,5,5,-4,-1,0,3,-3
1653,2009-11-28,West Ham,Burnley,5,3,H,2009-11-28,5,3,3,3,2,0,3,0,3
1654,2009-11-28,Wigan,Sunderland,1,0,H,2009-11-28,2,0,9,9,-7,-9,3,0,3
1655,2009-11-29,Arsenal,Chelsea,0,3,A,2009-12-05,2,4,3,3,-1,1,3,3,0
1656,2009-11-29,Everton,Liverpool,0,2,A,2009-12-05,0,2,2,2,-2,0,0,4,-4
1657,2009-11-29,Wolves,Birmingham,0,1,A,2009-12-05,2,4,2,2,0,2,3,6,-3
1658,2009-12-05,Arsenal,Stoke,2,0,H,2009-12-05,2,0,3,3,-1,-3,3,0,3
1659,2009-12-05,Aston Villa,Hull,3,0,H,2009-12-05,3,0,0,0,3,0,3,0,3
1660,2009-12-05,Blackburn,Liverpool,0,0,D,2009-12-05,0,2,0,0,0,2,1,4,-3
1661,2009-12-05,Man City,Chelsea,2,1,H,2009-12-05,2,4,1,1,1,3,3,3,0
1662,2009-12-05,Portsmouth,Burnley,2,0,H,2009-12-05,2,0,0,0,2,0,3,0,3
1663,2009-12-05,West Ham,Man United,0,4,A,2009-12-05,0,4,4,4,-4,0,0,3,-3
1664,2009-12-05,Wigan,Birmingham,2,3,A,2009-12-05,2,4,3,3,-1,1,0,6,-6
1665,2009-12-05,Wolves,Bolton,2,1,H,2009-12-05,2,1,2,2,0,-1,3,0,3
1666,2009-12-06,Everton,Tottenham,2,2,D,2009-12-12,5,2,5,5,0,-3,1,1,0
1667,2009-12-06,Fulham,Sunderland,1,0,H,2009-12-12,2,1,1,1,1,0,3,0,3
1668,2009-12-12,Birmingham,West Ham,1,0,H,2009-12-12,1,0,0,0,1,0,3,0,3
1669,2009-12-12,Bolton,Man City,3,3,D,2009-12-12,3,3,3,3,0,0,1,1,0
1670,2009-12-12,Burnley,Fulham,1,1,D,2009-12-12,1,2,1,1,0,1,1,1,0
1671,2009-12-12,Chelsea,Everton,3,3,D,2009-12-12,3,5,3,3,0,2,1,1,0
1672,2009-12-12,Hull,Blackburn,0,0,D,2009-12-12,0,0,0,0,0,0,1,1,0
1673,2009-12-12,Man United,Aston Villa,0,1,A,2009-12-12,0,1,1,1,-1,0,0,3,-3
1674,2009-12-12,Stoke,Wigan,2,2,D,2009-12-12,2,2,2,2,0,0,1,1,0
1675,2009-12-12,Sunderland,Portsmouth,1,1,D,2009-12-12,1,1,2,2,-1,-1,1,1,0
1676,2009-12-12,Tottenham,Wolves,0,1,A,2009-12-12,2,1,3,3,-1,-2,0,3,-3
1677,2009-12-13,Liverpool,Arsenal,1,2,A,2009-12-19,3,6,5,5,-2,1,3,4,-1
1678,2009-12-15,Birmingham,Blackburn,2,1,H,2009-12-19,2,1,1,1,1,0,3,0,3
1679,2009-12-15,Bolton,West Ham,3,1,H,2009-12-19,3,1,1,1,2,0,3,0,3
1680,2009-12-15,Man United,Wolves,3,0,H,2009-12-19,3,0,3,3,0,-3,3,0,3
1681,2009-12-15,Sunderland,Aston Villa,0,2,A,2009-12-19,3,3,6,6,-3,-3,0,3,-3
1682,2009-12-16,Burnley,Arsenal,1,1,D,2009-12-19,1,6,1,1,0,5,1,4,-3
1683,2009-12-16,Chelsea,Portsmouth,2,1,H,2009-12-19,2,3,1,1,1,2,3,0,3
1684,2009-12-16,Liverpool,Wigan,2,1,H,2009-12-19,3,1,5,5,-2,-4,3,0,3
1685,2009-12-16,Tottenham,Man City,3,0,H,2009-12-19,5,4,0,0,5,4,3,0,3
1686,2009-12-19,Arsenal,Hull,3,0,H,2009-12-19,6,0,2,2,4,-2,3,0,3
1687,2009-12-19,Aston Villa,Stoke,1,0,H,2009-12-19,3,0,0,0,3,0,3,0,3
1688,2009-12-19,Blackburn,Tottenham,0,2,A,2009-12-19,1,5,4,4,-3,1,0,3,-3
1689,2009-12-19,Fulham,Man United,3,0,H,2009-12-19,3,3,0,0,3,3,3,0,3
1690,2009-12-19,Man City,Sunderland,4,3,H,2009-12-19,4,3,6,6,-2,-3,3,0,3
1691,2009-12-19,Portsmouth,Liverpool,2,0,H,2009-12-19,3,3,2,2,1,1,3,0,3
1692,2009-12-20,Everton,Birmingham,1,1,D,2009-12-26,2,1,2,2,0,-1,1,1,0
1693,2009-12-20,West Ham,Chelsea,1,1,D,2009-12-26,3,1,1,1,2,0,4,2,2
1694,2009-12-20,Wolves,Burnley,2,0,H,2009-12-26,2,1,2,2,0,-1,3,0,3
1695,2009-12-26,Birmingham,Chelsea,0,0,D,2009-12-26,1,1,1,1,0,0,1,2,-1
1696,2009-12-26,Burnley,Bolton,1,1,D,2009-12-26,1,1,3,3,-2,-2,1,1,0
1697,2009-12-26,Fulham,Tottenham,0,0,D,2009-12-26,0,0,0,0,0,0,1,1,0
1698,2009-12-26,Liverpool,Wolves,2,0,H,2009-12-26,2,2,0,0,2,2,3,0,3
1699,2009-12-26,Man City,Stoke,2,0,H,2009-12-26,2,0,0,0,2,0,3,0,3
1700,2009-12-26,Sunderland,Everton,1,1,D,2009-12-26,1,2,1,1,0,1,1,1,0
1701,2009-12-26,West Ham,Portsmouth,2,0,H,2009-12-26,3,0,1,1,2,-1,4,0,4
1702,2009-12-26,Wigan,Blackburn,1,1,D,2009-12-26,1,1,1,1,0,0,1,1,0
1703,2009-12-27,Arsenal,Aston Villa,3,0,H,2010-01-02,7,0,1,1,6,-1,3,0,3
1704,2009-12-27,Hull,Man United,1,3,A,2010-01-02,3,8,5,5,-2,3,0,3,-3
1705,2009-12-28,Blackburn,Sunderland,2,2,D,2010-01-02,2,2,2,2,0,0,1,1,0
1706,2009-12-28,Chelsea,Fulham,2,1,H,2010-01-02,2,1,1,1,1,0,3,0,3
1707,2009-12-28,Everton,Burnley,2,0,H,2010-01-02,2,0,0,0,2,0,3,0,3
1708,2009-12-28,Stoke,Birmingham,0,1,A,2010-01-02,0,1,1,1,-1,0,0,3,-3
1709,2009-12-28,Tottenham,West Ham,2,0,H,2010-01-02,2,0,0,0,2,0,3,0,3
1710,2009-12-28,Wolves,Man City,0,3,A,2010-01-02,0,3,3,3,-3,0,0,3,-3
1711,2009-12-29,Aston Villa,Liverpool,0,1,A,2010-01-02,0,1,4,4,-4,-3,0,3,-3
1712,2009-12-29,Bolton,Hull,2,2,D,2010-01-02,2,3,2,2,0,1,1,1,0
1713,2009-12-30,Man United,Wigan,5,0,H,2010-01-02,8,0,1,1,7,-1,3,0,3
1714,2009-12-30,Portsmouth,Arsenal,1,4,A,2010-01-02,1,7,4,4,-3,3,0,3,-3
1715,2010-01-05,Stoke,Fulham,3,2,H,2010-01-09,3,2,2,2,1,0,3,0,3
1716,2010-01-09,Arsenal,Everton,2,2,D,2010-01-09,2,2,2,2,0,0,1,1,0
1717,2010-01-09,Birmingham,Man United,1,1,D,2010-01-09,1,1,1,1,0,0,1,1,0
1718,2010-01-11,Man City,Blackburn,4,1,H,2010-01-16,4,1,3,3,1,-2,3,0,3
1719,2010-01-16,Chelsea,Sunderland,7,2,H,2010-01-16,7,2,2,2,5,0,3,0,3
1720,2010-01-16,Everton,Man City,2,0,H,2010-01-16,2,4,0,0,2,4,3,0,3
1721,2010-01-16,Man United,Burnley,3,0,H,2010-01-16,3,0,0,0,3,0,3,0,3
1722,2010-01-16,Stoke,Liverpool,1,1,D,2010-01-16,1,1,1,1,0,0,1,1,0
1723,2010-01-16,Tottenham,Hull,0,0,D,2010-01-16,0,0,0,0,0,0,1,1,0
1724,2010-01-16,Wolves,Wigan,0,2,A,2010-01-16,0,2,2,2,-2,0,0,3,-3
1725,2010-01-17,Aston Villa,West Ham,0,0,D,2010-01-23,0,0,0,0,0,0,1,1,0
1726,2010-01-17,Blackburn,Fulham,2,0,H,2010-01-23,2,0,0,0,2,0,3,0,3
1727,2010-01-17,Bolton,Arsenal,0,2,A,2010-01-23,2,6,6,6,-4,0,0,3,-3
1728,2010-01-20,Arsenal,Bolton,4,2,H,2010-01-23,6,2,2,2,4,0,3,0,3
1729,2010-01-20,Liverpool,Tottenham,2,0,H,2010-01-23,2,0,0,0,2,0,3,0,3
1730,2010-01-23,Man United,Hull,4,0,H,2010-01-23,4,0,0,0,4,0,3,0,3
1731,2010-01-26,Bolton,Burnley,1,0,H,2010-01-30,1,1,2,2,-1,-1,3,0,3
1732,2010-01-26,Portsmouth,West Ham,1,1,D,2010-01-30,1,1,1,1,0,0,1,1,0
1733,2010-01-26,Tottenham,Fulham,2,0,H,2010-01-30,3,0,1,1,2,-1,3,0,3
1734,2010-01-26,Wolves,Liverpool,0,0,D,2010-01-30,2,2,2,2,0,0,1,1,0
1735,2010-01-27,Aston Villa,Arsenal,0,0,D,2010-01-30,2,0,0,0,2,0,1,1,0
1736,2010-01-27,Blackburn,Wigan,2,1,H,2010-01-30,2,1,1,1,1,0,3,0,3
1737,2010-01-27,Chelsea,Birmingham,3,0,H,2010-01-30,5,1,1,1,4,0,3,0,3
1738,2010-01-27,Everton,Sunderland,2,0,H,2010-01-30,3,0,0,0,3,0,3,0,3
1739,2010-01-30,Birmingham,Tottenham,1,1,D,2010-01-30,1,3,4,4,-3,-1,1,1,0
1740,2010-01-30,Burnley,Chelsea,1,2,A,2010-01-30,1,5,3,3,-2,2,0,3,-3
1741,2010-01-30,Fulham,Aston Villa,0,2,A,2010-01-30,0,2,4,4,-4,-2,0,3,-3
1742,2010-01-30,Hull,Wolves,2,2,D,2010-01-30,2,2,2,2,0,0,1,1,0
1743,2010-01-30,Liverpool,Bolton,2,0,H,2010-01-30,2,1,0,0,2,1,3,0,3
1744,2010-01-30,West Ham,Blackburn,0,0,D,2010-01-30,1,2,1,1,0,1,1,1,0
1745,2010-01-30,Wigan,Everton,0,1,A,2010-01-30,1,3,3,3,-2,0,0,3,-3
1746,2010-01-31,Arsenal,Man United,1,3,A,2010-02-06,1,8,3,3,-2,5,0,3,-3
1747,2010-01-31,Man City,Portsmouth,2,0,H,2010-02-06,3,0,2,2,1,-2,3,0,3
1748,2010-02-01,Sunderland,Stoke,0,0,D,2010-02-06,1,3,1,1,0,2,2,1,1
1749,2010-02-02,Hull,Chelsea,1,1,D,2010-02-06,3,1,2,2,1,-1,4,1,3
1750,2010-02-03,Fulham,Portsmouth,1,0,H,2010-02-06,1,0,0,0,1,0,3,0,3
1751,2010-02-06,Bolton,Fulham,0,0,D,2010-02-06,0,1,0,0,0,1,1,1,0
1752,2010-02-06,Burnley,West Ham,2,1,H,2010-02-06,2,1,1,1,1,0,3,0,3
1753,2010-02-06,Hull,Man City,2,1,H,2010-02-06,3,3,2,2,1,1,4,0,4
1754,2010-02-06,Liverpool,Everton,1,0,H,2010-02-06,1,0,0,0,1,0,3,0,3
1755,2010-02-06,Man United,Portsmouth,5,0,H,2010-02-06,8,0,1,1,7,-1,3,0,3
1756,2010-02-06,Stoke,Blackburn,3,0,H,2010-02-06,3,0,0,0,3,0,3,0,3
1757,2010-02-06,Sunderland,Wigan,1,1,D,2010-02-06,1,1,1,1,0,0,2,1,1
1758,2010-02-06,Tottenham,Aston Villa,0,0,D,2010-02-06,0,0,0,0,0,0,1,1,0
1759,2010-02-07,Birmingham,Wolves,2,1,H,2010-02-13,2,2,3,3,-1,-1,3,0,3
1760,2010-02-07,Chelsea,Arsenal,2,0,H,2010-02-13,3,1,2,2,1,-1,3,0,3
1761,2010-02-09,Fulham,Burnley,3,0,H,2010-02-13,3,0,0,0,3,0,3,0,3
1762,2010-02-09,Man City,Bolton,2,0,H,2010-02-13,2,0,0,0,2,0,3,0,3
1763,2010-02-09,Portsmouth,Sunderland,1,1,D,2010-02-13,1,1,1,1,0,0,1,1,0
1764,2010-02-09,Wigan,Stoke,1,1,D,2010-02-13,1,1,1,1,0,0,1,1,0
1765,2010-02-10,Arsenal,Liverpool,1,0,H,2010-02-13,1,0,2,2,-1,-2,3,0,3
1766,2010-02-10,Aston Villa,Man United,1,1,D,2010-02-13,1,1,1,1,0,0,1,1,0
1767,2010-02-10,Blackburn,Hull,1,0,H,2010-02-13,1,0,0,0,1,0,3,0,3
1768,2010-02-10,Everton,Chelsea,2,1,H,2010-02-13,2,3,1,1,1,2,3,0,3
1769,2010-02-10,West Ham,Birmingham,2,0,H,2010-02-13,2,2,0,0,2,2,3,0,3
1770,2010-02-10,Wolves,Tottenham,1,0,H,2010-02-13,2,0,2,2,0,-2,3,0,3
1771,2010-02-16,Stoke,Man City,1,1,D,2010-02-20,3,1,2,2,1,-1,1,1,0
1772,2010-02-17,Wigan,Bolton,0,0,D,2010-02-20,0,0,0,0,0,0,1,1,0
1773,2010-02-20,Arsenal,Sunderland,2,0,H,2010-02-20,2,0,0,0,2,0,3,0,3
1774,2010-02-20,Everton,Man United,3,1,H,2010-02-20,3,1,1,1,2,0,3,0,3
1775,2010-02-20,Portsmouth,Stoke,1,2,A,2010-02-20,1,3,2,2,-1,1,0,3,-3
1776,2010-02-20,West Ham,Hull,3,0,H,2010-02-20,3,0,0,0,3,0,3,0,3
1777,2010-02-20,Wolves,Chelsea,0,2,A,2010-02-20,0,2,2,2,-2,0,0,3,-3
1778,2010-02-21,Aston Villa,Burnley,5,2,H,2010-02-27,5,3,2,2,3,1,3,0,3
1779,2010-02-21,Blackburn,Bolton,3,0,H,2010-02-27,3,1,0,0,3,1,3,0,3
1780,2010-02-21,Fulham,Birmingham,2,1,H,2010-02-27,2,2,1,1,1,1,3,0,3
1781,2010-02-21,Man City,Liverpool,0,0,D,2010-02-27,4,0,2,2,2,-2,1,1,0
1782,2010-02-21,Wigan,Tottenham,0,3,A,2010-02-27,0,3,4,4,-4,-1,0,3,-3
1783,2010-02-23,Man United,West Ham,3,0,H,2010-02-27,3,0,0,0,3,0,3,0,3
1784,2010-02-27,Birmingham,Wigan,1,0,H,2010-02-27,2,0,2,2,0,-2,3,0,3
1785,2010-02-27,Bolton,Wolves,1,0,H,2010-02-27,1,0,3,3,-2,-3,3,0,3
1786,2010-02-27,Burnley,Portsmouth,1,2,A,2010-02-27,3,2,7,7,-4,-5,0,3,-3
1787,2010-02-27,Chelsea,Man City,2,4,A,2010-02-27,2,4,4,4,-2,0,0,3,-3
1788,2010-02-27,Stoke,Arsenal,1,3,A,2010-02-27,1,3,3,3,-2,0,0,3,-3
1789,2010-02-28,Liverpool,Blackburn,2,1,H,2010-03-06,2,1,1,1,1,0,3,0,3
1790,2010-02-28,Sunderland,Fulham,0,0,D,2010-03-06,0,0,0,0,0,0,1,1,0
1791,2010-02-28,Tottenham,Everton,2,1,H,2010-03-06,2,1,1,1,1,0,3,0,3
1792,2010-03-06,Arsenal,Burnley,3,1,H,2010-03-06,3,1,1,1,2,0,3,0,3
1793,2010-03-06,West Ham,Bolton,1,2,A,2010-03-06,1,2,2,2,-1,0,0,3,-3
1794,2010-03-06,Wolves,Man United,0,1,A,2010-03-06,0,1,1,1,-1,0,0,3,-3
1795,2010-03-07,Everton,Hull,5,1,H,2010-03-13,7,2,3,3,4,-1,3,0,3
1796,2010-03-08,Wigan,Liverpool,1,0,H,2010-03-13,1,0,4,4,-3,-4,3,0,3
1797,2010-03-09,Portsmouth,Birmingham,1,2,A,2010-03-13,1,4,2,2,-1,2,0,3,-3
1798,2010-03-09,Sunderland,Bolton,4,0,H,2010-03-13,4,4,0,0,4,4,3,0,3
1799,2010-03-10,Burnley,Stoke,1,1,D,2010-03-13,2,1,3,3,-1,-2,1,1,0
1800,2010-03-13,Birmingham,Everton,2,2,D,2010-03-13,4,7,3,3,1,4,1,1,0
1801,2010-03-13,Bolton,Wigan,4,0,H,2010-03-13,4,1,4,4,0,-3,3,0,3
1802,2010-03-13,Burnley,Wolves,1,2,A,2010-03-13,2,2,3,3,-1,-1,1,3,-2
1803,2010-03-13,Chelsea,West Ham,4,1,H,2010-03-13,4,1,1,1,3,0,3,0,3
1804,2010-03-13,Hull,Arsenal,1,2,A,2010-03-13,2,2,7,7,-5,-5,0,3,-3
1805,2010-03-13,Stoke,Aston Villa,0,0,D,2010-03-13,1,0,1,1,0,-1,1,1,0
1806,2010-03-13,Tottenham,Blackburn,3,1,H,2010-03-13,3,1,1,1,2,0,3,0,3
1807,2010-03-14,Man United,Fulham,3,0,H,2010-03-20,3,0,0,0,3,0,3,0,3
1808,2010-03-14,Sunderland,Man City,1,1,D,2010-03-20,4,1,2,2,2,-1,4,1,3
1809,2010-03-15,Liverpool,Portsmouth,4,1,H,2010-03-20,4,4,1,1,3,3,3,0,3
1810,2010-03-16,Wigan,Aston Villa,1,2,A,2010-03-20,2,4,2,2,0,2,3,3,0
1811,2010-03-20,Arsenal,West Ham,2,0,H,2010-03-20,2,0,0,0,2,0,3,0,3
1812,2010-03-20,Aston Villa,Wolves,2,2,D,2010-03-20,4,2,3,3,1,-1,1,1,0
1813,2010-03-20,Everton,Bolton,2,0,H,2010-03-20,2,0,0,0,2,0,3,0,3
1814,2010-03-20,Portsmouth,Hull,3,2,H,2010-03-20,4,2,6,6,-2,-4,3,0,3
1815,2010-03-20,Stoke,Tottenham,1,2,A,2010-03-20,1,2,2,2,-1,0,0,3,-3
1816,2010-03-20,Sunderland,Birmingham,3,1,H,2010-03-20,4,1,2,2,2,-1,4,0,4
1817,2010-03-20,Wigan,Burnley,1,0,H,2010-03-20,2,0,2,2,0,-2,3,0,3
1818,2010-03-21,Blackburn,Chelsea,1,1,D,2010-03-27,3,13,2,2,1,11,4,4,0
1819,2010-03-21,Fulham,Man City,1,2,A,2010-03-27,1,2,4,4,-3,-2,0,3,-3
1820,2010-03-21,Man United,Liverpool,2,1,H,2010-03-27,6,1,1,1,5,0,3,0,3
1821,2010-03-23,West Ham,Wolves,1,3,A,2010-03-27,1,3,4,4,-3,-1,0,3,-3
1822,2010-03-24,Aston Villa,Sunderland,1,1,D,2010-03-27,2,1,8,8,-6,-7,1,1,0
1823,2010-03-24,Blackburn,Birmingham,2,1,H,2010-03-27,3,2,2,2,1,0,4,0,4
1824,2010-03-24,Man City,Everton,0,2,A,2010-03-27,2,2,3,3,-1,-1,0,4,-4
1825,2010-03-24,Portsmouth,Chelsea,0,5,A,2010-03-27,0,13,7,7,-7,6,0,4,-4
1826,2010-03-27,Birmingham,Arsenal,1,1,D,2010-03-27,2,1,3,3,-1,-2,1,1,0
1827,2010-03-27,Bolton,Man United,0,4,A,2010-03-27,0,6,4,4,-4,2,0,3,-3
1828,2010-03-27,Chelsea,Aston Villa,7,1,H,2010-03-27,13,2,2,2,11,0,3,0,3
1829,2010-03-27,Hull,Fulham,2,0,H,2010-03-27,2,1,0,0,2,1,3,0,3
1830,2010-03-27,Tottenham,Portsmouth,2,0,H,2010-03-27,2,0,0,0,2,0,3,0,3
1831,2010-03-27,West Ham,Stoke,0,1,A,2010-03-27,1,1,4,4,-3,-3,0,3,-3
1832,2010-03-27,Wolves,Everton,0,0,D,2010-03-27,3,2,1,1,2,1,1,4,-3
1833,2010-03-28,Burnley,Blackburn,0,1,A,2010-04-03,1,1,7,7,-6,-6,0,4,-4
1834,2010-03-28,Liverpool,Sunderland,3,0,H,2010-04-03,3,3,0,0,3,3,3,0,3
1835,2010-03-29,Man City,Wigan,3,0,H,2010-04-03,9,0,1,1,8,-1,3,0,3
1836,2010-04-03,Arsenal,Wolves,1,0,H,2010-04-03,1,0,0,0,1,0,3,0,3
1837,2010-04-03,Bolton,Aston Villa,0,1,A,2010-04-03,0,1,1,1,-1,0,0,3,-3
1838,2010-04-03,Burnley,Man City,1,6,A,2010-04-03,1,9,7,7,-6,2,0,3,-3
1839,2010-04-03,Man United,Chelsea,1,2,A,2010-04-03,1,2,2,2,-1,0,0,3,-3
1840,2010-04-03,Portsmouth,Blackburn,0,0,D,2010-04-03,0,1,0,0,0,1,1,4,-3
1841,2010-04-03,Stoke,Hull,2,0,H,2010-04-03,2,0,0,0,2,0,3,0,3
1842,2010-04-03,Sunderland,Tottenham,3,1,H,2010-04-03,3,1,4,4,-1,-3,3,0,3
1843,2010-04-04,Birmingham,Liverpool,1,1,D,2010-04-10,1,1,1,1,0,0,1,1,0
1844,2010-04-04,Everton,West Ham,2,2,D,2010-04-10,2,3,2,2,0,1,1,1,0
1845,2010-04-04,Fulham,Wigan,2,1,H,2010-04-10,2,1,1,1,1,0,3,0,3
1846,2010-04-10,Hull,Burnley,1,4,A,2010-04-10,1,4,4,4,-3,0,0,3,-3
1847,2010-04-10,West Ham,Sunderland,1,0,H,2010-04-10,3,0,2,2,1,-2,3,0,3
1848,2010-04-11,Blackburn,Man United,0,0,D,2010-04-17,2,1,3,3,-1,-2,1,4,-3
1849,2010-04-11,Liverpool,Fulham,0,0,D,2010-04-17,0,0,0,0,0,0,1,1,0
1850,2010-04-11,Man City,Birmingham,5,1,H,2010-04-17,5,1,2,2,3,-1,3,0,3
1851,2010-04-11,Wolves,Stoke,0,0,D,2010-04-17,0,1,0,0,0,1,1,1,0
1852,2010-04-13,Chelsea,Bolton,1,0,H,2010-04-17,2,2,2,2,0,0,3,3,0
1853,2010-04-14,Aston Villa,Everton,2,2,D,2010-04-17,2,5,2,2,0,3,1,4,-3
1854,2010-04-14,Tottenham,Arsenal,2,1,H,2010-04-17,4,1,2,2,2,-1,6,0,6
1855,2010-04-14,Wigan,Portsmouth,0,0,D,2010-04-17,0,0,0,0,0,0,1,1,0
1856,2010-04-17,Birmingham,Hull,0,0,D,2010-04-17,1,0,5,5,-4,-5,1,1,0
1857,2010-04-17,Blackburn,Everton,2,3,A,2010-04-17,2,5,3,3,-1,2,1,4,-3
1858,2010-04-17,Fulham,Wolves,0,0,D,2010-04-17,0,0,0,0,0,0,1,1,0
1859,2010-04-17,Man City,Man United,0,1,A,2010-04-17,5,1,2,2,3,-1,3,4,-1
1860,2010-04-17,Stoke,Bolton,1,2,A,2010-04-17,1,2,2,2,-1,0,0,3,-3
1861,2010-04-17,Sunderland,Burnley,2,1,H,2010-04-17,2,1,1,1,1,0,3,0,3
1862,2010-04-17,Tottenham,Chelsea,2,1,H,2010-04-17,4,2,2,2,2,0,6,0,6
1863,2010-04-18,Portsmouth,Aston Villa,1,2,A,2010-04-24,3,4,4,4,-1,0,0,6,-6
1864,2010-04-18,Wigan,Arsenal,3,2,H,2010-04-24,5,2,5,5,0,-3,3,0,3
1865,2010-04-19,Liverpool,West Ham,3,0,H,2010-04-24,3,3,0,0,3,3,3,0,3
1866,2010-04-21,Hull,Aston Villa,0,2,A,2010-04-24,0,4,3,3,-3,1,0,6,-6
1867,2010-04-24,Arsenal,Man City,0,0,D,2010-04-24,2,0,3,3,-1,-3,1,1,0
1868,2010-04-24,Bolton,Portsmouth,2,2,D,2010-04-24,2,3,2,2,0,1,1,1,0
1869,2010-04-24,Hull,Sunderland,0,1,A,2010-04-24,0,1,3,3,-3,-2,0,3,-3
1870,2010-04-24,Man United,Tottenham,3,1,H,2010-04-24,3,1,1,1,2,0,3,0,3
1871,2010-04-24,West Ham,Wigan,3,2,H,2010-04-24,3,5,5,5,-2,0,3,0,3
1872,2010-04-24,Wolves,Blackburn,1,1,D,2010-04-24,1,1,1,1,0,0,1,1,0
1873,2010-04-25,Aston Villa,Birmingham,1,0,H,2010-05-01,2,2,3,3,-1,-1,3,0,3
1874,2010-04-25,Burnley,Liverpool,0,4,A,2010-05-01,1,4,6,6,-5,-2,0,3,-3
1875,2010-04-25,Chelsea,Stoke,7,0,H,2010-05-01,7,0,0,0,7,0,3,0,3
1876,2010-04-25,Everton,Fulham,2,1,H,2010-05-01,2,1,1,1,1,0,3,0,3
1877,2010-05-01,Birmingham,Burnley,2,1,H,2010-05-01,2,1,2,2,0,-1,3,0,3
1878,2010-05-01,Man City,Aston Villa,3,1,H,2010-05-01,3,2,1,1,2,1,3,0,3
1879,2010-05-01,Portsmouth,Wolves,3,1,H,2010-05-01,3,1,1,1,2,0,3,0,3
1880,2010-05-01,Stoke,Everton,0,0,D,2010-05-01,0,2,7,7,-7,-5,1,1,0
1881,2010-05-01,Tottenham,Bolton,1,0,H,2010-05-01,1,0,0,0,1,0,3,0,3
1882,2010-05-02,Fulham,West Ham,3,2,H,2010-05-08,3,2,3,3,0,-1,3,0,3
1883,2010-05-02,Liverpool,Chelsea,0,2,A,2010-05-08,0,2,2,2,-2,0,0,3,-3
1884,2010-05-02,Sunderland,Man United,0,1,A,2010-05-08,0,1,1,1,-1,0,0,3,-3
1885,2010-05-03,Blackburn,Arsenal,2,1,H,2010-05-08,2,1,1,1,1,0,3,0,3
1886,2010-05-03,Wigan,Hull,2,2,D,2010-05-08,2,2,2,2,0,0,1,1,0
1887,2010-05-05,Fulham,Stoke,0,1,A,2010-05-08,3,1,3,3,0,-2,3,3,0
1888,2010-05-05,Man City,Tottenham,0,1,A,2010-05-08,0,1,1,1,-1,0,0,3,-3
1889,2010-05-09,Arsenal,Fulham,4,0,H,2010-05-15,4,0,0,0,4,0,3,0,3
1890,2010-05-09,Aston Villa,Blackburn,0,1,A,2010-05-15,0,1,1,1,-1,0,0,3,-3
1891,2010-05-09,Bolton,Birmingham,2,1,H,2010-05-15,2,1,1,1,1,0,3,0,3
1892,2010-05-09,Burnley,Tottenham,4,2,H,2010-05-15,4,2,2,2,2,0,3,0,3
1893,2010-05-09,Chelsea,Wigan,8,0,H,2010-05-15,8,0,0,0,8,0,3,0,3
1894,2010-05-09,Everton,Portsmouth,1,0,H,2010-05-15,1,0,0,0,1,0,3,0,3
1895,2010-05-09,Hull,Liverpool,0,0,D,2010-05-15,0,0,0,0,0,0,1,1,0
1896,2010-05-09,Man United,Stoke,4,0,H,2010-05-15,4,0,0,0,4,0,3,0,3
1897,2010-05-09,West Ham,Man City,1,1,D,2010-05-15,1,1,1,1,0,0,1,1,0
1898,2010-05-09,Wolves,Sunderland,2,1,H,2010-05-15,2,1,1,1,1,0,3,0,3
1899,2010-08-14,Aston Villa,West Ham,3,0,H,2010-08-14,3,0,0,0,3,0,3,0,3
1900,2010-08-14,Blackburn,Everton,1,0,H,2010-08-14,1,0,0,0,1,0,3,0,3
1901,2010-08-14,Bolton,Fulham,0,0,D,2010-08-14,0,0,0,0,0,0,1,1,0
1902,2010-08-14,Chelsea,West Brom,6,0,H,2010-08-14,6,0,0,0,6,0,3,0,3
1903,2010-08-14,Sunderland,Birmingham,2,2,D,2010-08-14,2,2,2,2,0,0,1,1,0
1904,2010-08-14,Tottenham,Man City,0,0,D,2010-08-14,0,0,0,0,0,0,1,1,0
1905,2010-08-14,Wigan,Blackpool,0,4,A,2010-08-14,0,4,4,4,-4,0,0,3,-3
1906,2010-08-14,Wolves,Stoke,2,1,H,2010-08-14,2,1,1,1,1,0,3,0,3
1907,2010-08-15,Liverpool,Arsenal,1,1,D,2010-08-21,1,7,1,1,0,6,1,1,0
1908,2010-08-16,Man United,Newcastle,3,0,H,2010-08-21,3,0,0,0,3,0,3,0,3
1909,2010-08-21,Arsenal,Blackpool,6,0,H,2010-08-21,7,0,1,1,6,-1,3,0,3
1910,2010-08-21,Birmingham,Blackburn,2,1,H,2010-08-21,2,1,1,1,1,0,3,0,3
1911,2010-08-21,Everton,Wolves,1,1,D,2010-08-21,1,1,1,1,0,0,1,1,0
1912,2010-08-21,Stoke,Tottenham,1,2,A,2010-08-21,1,2,2,2,-1,0,0,3,-3
1913,2010-08-21,West Brom,Sunderland,1,0,H,2010-08-21,1,0,0,0,1,0,3,0,3
1914,2010-08-21,West Ham,Bolton,1,3,A,2010-08-21,1,3,3,3,-2,0,0,3,-3
1915,2010-08-21,Wigan,Chelsea,0,6,A,2010-08-21,0,6,6,6,-6,0,0,3,-3
1916,2010-08-22,Fulham,Man United,2,2,D,2010-08-28,4,5,4,4,0,1,1,1,0
1917,2010-08-22,Newcastle,Aston Villa,6,0,H,2010-08-28,7,0,1,1,6,-1,3,0,3
1918,2010-08-23,Man City,Liverpool,3,0,H,2010-08-28,3,0,0,0,3,0,3,0,3
1919,2010-08-28,Blackburn,Arsenal,1,2,A,2010-08-28,1,2,2,2,-1,0,0,3,-3
1920,2010-08-28,Blackpool,Fulham,2,2,D,2010-08-28,2,4,2,2,0,2,1,1,0
1921,2010-08-28,Chelsea,Stoke,2,0,H,2010-08-28,2,0,0,0,2,0,3,0,3
1922,2010-08-28,Man United,West Ham,3,0,H,2010-08-28,5,0,2,2,3,-2,3,0,3
1923,2010-08-28,Tottenham,Wigan,0,1,A,2010-08-28,0,1,1,1,-1,0,0,3,-3
1924,2010-08-28,Wolves,Newcastle,1,1,D,2010-08-28,1,7,1,1,0,6,1,1,0
1925,2010-08-29,Aston Villa,Everton,1,0,H,2010-09-04,1,0,0,0,1,0,3,0,3
1926,2010-08-29,Bolton,Birmingham,2,2,D,2010-09-04,2,2,2,2,0,0,1,1,0
1927,2010-08-29,Liverpool,West Brom,1,0,H,2010-09-04,1,0,0,0,1,0,3,0,3
1928,2010-08-29,Sunderland,Man City,1,0,H,2010-09-04,1,0,0,0,1,0,3,0,3
1929,2010-09-11,Arsenal,Bolton,4,1,H,2010-09-11,4,1,1,1,3,0,3,0,3
1930,2010-09-11,Everton,Man United,3,3,D,2010-09-11,3,3,3,3,0,0,1,1,0
1931,2010-09-11,Fulham,Wolves,2,1,H,2010-09-11,2,1,1,1,1,0,3,0,3
1932,2010-09-11,Man City,Blackburn,1,1,D,2010-09-11,1,1,1,1,0,0,1,1,0
1933,2010-09-11,Newcastle,Blackpool,0,2,A,2010-09-11,0,2,2,2,-2,0,0,3,-3
1934,2010-09-11,West Brom,Tottenham,1,1,D,2010-09-11,1,1,1,1,0,0,1,1,0
1935,2010-09-11,West Ham,Chelsea,1,3,A,2010-09-11,1,3,3,3,-2,0,0,3,-3
1936,2010-09-11,Wigan,Sunderland,1,1,D,2010-09-11,1,1,1,1,0,0,1,1,0
1937,2010-09-12,Birmingham,Liverpool,0,0,D,2010-09-18,1,0,3,3,-2,-3,1,1,0
1938,2010-09-13,Stoke,Aston Villa,2,1,H,2010-09-18,3,2,2,2,1,0,4,0,4
1939,2010-09-18,Aston Villa,Bolton,1,1,D,2010-09-18,2,1,3,3,-1,-2,1,1,0
1940,2010-09-18,Blackburn,Fulham,1,1,D,2010-09-18,1,1,1,1,0,0,1,1,0
1941,2010-09-18,Everton,Newcastle,0,1,A,2010-09-18,0,1,1,1,-1,0,0,3,-3
1942,2010-09-18,Stoke,West Ham,1,1,D,2010-09-18,3,1,2,2,1,-1,4,1,3
1943,2010-09-18,Sunderland,Arsenal,1,1,D,2010-09-18,1,1,1,1,0,0,1,1,0
1944,2010-09-18,Tottenham,Wolves,3,1,H,2010-09-18,3,1,1,1,2,0,3,0,3
1945,2010-09-18,West Brom,Birmingham,3,1,H,2010-09-18,3,1,1,1,2,0,3,0,3
1946,2010-09-19,Chelsea,Blackpool,4,0,H,2010-09-25,4,1,1,1,3,0,3,0,3
1947,2010-09-19,Man United,Liverpool,3,2,H,2010-09-25,3,4,2,2,1,2,3,0,3
1948,2010-09-19,Wigan,Man City,0,2,A,2010-09-25,0,3,2,2,-2,1,0,3,-3
1949,2010-09-25,Arsenal,West Brom,2,3,A,2010-09-25,2,3,3,3,-1,0,0,3,-3
1950,2010-09-25,Birmingham,Wigan,0,0,D,2010-09-25,0,0,0,0,0,0,1,1,0
1951,2010-09-25,Blackpool,Blackburn,1,2,A,2010-09-25,1,2,6,6,-5,-4,0,3,-3
1952,2010-09-25,Fulham,Everton,0,0,D,2010-09-25,0,0,0,0,0,0,1,1,0
1953,2010-09-25,Liverpool,Sunderland,2,2,D,2010-09-25,4,2,5,5,-1,-3,1,1,0
1954,2010-09-25,Man City,Chelsea,1,0,H,2010-09-25,3,4,0,0,3,4,3,0,3
1955,2010-09-25,West Ham,Tottenham,1,0,H,2010-09-25,1,0,0,0,1,0,3,0,3
1956,2010-09-26,Bolton,Man United,2,2,D,2010-10-02,3,2,3,3,0,-1,1,2,-1
1957,2010-09-26,Newcastle,Stoke,1,2,A,2010-10-02,1,3,2,2,-1,1,0,3,-3
1958,2010-09-26,Wolves,Aston Villa,1,2,A,2010-10-02,1,3,4,4,-3,-1,0,3,-3
1959,2010-10-02,Birmingham,Everton,0,2,A,2010-10-02,0,2,2,2,-2,0,0,3,-3
1960,2010-10-02,Stoke,Blackburn,1,0,H,2010-10-02,3,0,1,1,2,-1,3,0,3
1961,2010-10-02,Sunderland,Man United,0,0,D,2010-10-02,0,2,0,0,0,2,1,2,-1
1962,2010-10-02,Tottenham,Aston Villa,2,1,H,2010-10-02,2,3,1,1,1,2,3,3,0
1963,2010-10-02,West Brom,Bolton,1,1,D,2010-10-02,1,3,1,1,0,2,1,1,0
1964,2010-10-02,West Ham,Fulham,1,1,D,2010-10-02,1,1,1,1,0,0,1,1,0
1965,2010-10-02,Wigan,Wolves,2,0,H,2010-10-02,2,1,0,0,2,1,3,0,3
1966,2010-10-03,Chelsea,Arsenal,2,0,H,2010-10-09,2,0,0,0,2,0,3,0,3
1967,2010-10-03,Liverpool,Blackpool,1,2,A,2010-10-09,1,2,2,2,-1,0,0,3,-3
1968,2010-10-03,Man City,Newcastle,2,1,H,2010-10-09,2,1,1,1,1,0,3,0,3
1969,2010-10-16,Arsenal,Birmingham,2,1,H,2010-10-16,2,1,1,1,1,0,3,0,3
1970,2010-10-16,Aston Villa,Chelsea,0,0,D,2010-10-16,0,0,0,0,0,0,1,1,0
1971,2010-10-16,Bolton,Stoke,2,1,H,2010-10-16,2,1,1,1,1,0,3,0,3
1972,2010-10-16,Fulham,Tottenham,1,2,A,2010-10-16,1,2,2,2,-1,0,0,3,-3
1973,2010-10-16,Man United,West Brom,2,2,D,2010-10-16,2,2,2,2,0,0,1,1,0
1974,2010-10-16,Newcastle,Wigan,2,2,D,2010-10-16,2,2,2,2,0,0,1,1,0
1975,2010-10-16,Wolves,West Ham,1,1,D,2010-10-16,1,1,1,1,0,0,1,1,0
1976,2010-10-17,Blackpool,Man City,2,3,A,2010-10-23,2,3,5,5,-3,-2,0,3,-3
1977,2010-10-17,Everton,Liverpool,2,0,H,2010-10-23,3,0,1,1,2,-1,3,0,3
1978,2010-10-18,Blackburn,Sunderland,0,0,D,2010-10-23,0,1,0,0,0,1,1,1,0
1979,2010-10-23,Birmingham,Blackpool,2,0,H,2010-10-23,2,2,0,0,2,2,3,0,3
1980,2010-10-23,Chelsea,Wolves,2,0,H,2010-10-23,2,0,0,0,2,0,3,0,3
1981,2010-10-23,Sunderland,Aston Villa,1,0,H,2010-10-23,1,0,0,0,1,0,3,0,3
1982,2010-10-23,Tottenham,Everton,1,1,D,2010-10-23,1,3,1,1,0,2,1,1,0
1983,2010-10-23,West Brom,Fulham,2,1,H,2010-10-23,2,1,1,1,1,0,3,0,3
1984,2010-10-23,West Ham,Newcastle,1,2,A,2010-10-23,1,2,2,2,-1,0,0,3,-3
1985,2010-10-23,Wigan,Bolton,1,1,D,2010-10-23,1,1,1,1,0,0,1,1,0
1986,2010-10-24,Liverpool,Blackburn,2,1,H,2010-10-30,2,2,1,1,1,1,3,0,3
1987,2010-10-24,Man City,Arsenal,0,3,A,2010-10-30,1,4,5,5,-4,-1,0,3,-3
1988,2010-10-24,Stoke,Man United,1,2,A,2010-10-30,1,4,3,3,-2,1,0,3,-3
1989,2010-10-30,Arsenal,West Ham,1,0,H,2010-10-30,4,0,0,0,4,0,3,0,3
1990,2010-10-30,Blackburn,Chelsea,1,2,A,2010-10-30,2,2,4,4,-2,-2,0,3,-3
1991,2010-10-30,Everton,Stoke,1,0,H,2010-10-30,1,1,0,0,1,1,3,0,3
1992,2010-10-30,Fulham,Wigan,2,0,H,2010-10-30,2,0,0,0,2,0,3,0,3
1993,2010-10-30,Man United,Tottenham,2,0,H,2010-10-30,4,0,1,1,3,-1,3,0,3
1994,2010-10-30,Wolves,Man City,2,1,H,2010-10-30,2,1,1,1,1,0,3,0,3
1995,2010-10-31,Aston Villa,Birmingham,0,0,D,2010-11-06,1,2,1,1,0,1,1,1,0
1996,2010-10-31,Bolton,Liverpool,0,1,A,2010-11-06,4,1,3,3,1,-2,3,3,0
1997,2010-10-31,Newcastle,Sunderland,5,1,H,2010-11-06,5,3,1,1,4,2,3,0,3
1998,2010-11-01,Blackpool,West Brom,2,1,H,2010-11-06,4,1,3,3,1,-2,4,0,4
1999,2010-11-06,Birmingham,West Ham,2,2,D,2010-11-06,2,2,2,2,0,0,1,1,0
2000,2010-11-06,Blackburn,Wigan,2,1,H,2010-11-06,2,1,1,1,1,0,3,0,3
2001,2010-11-06,Blackpool,Everton,2,2,D,2010-11-06,4,2,3,3,1,-1,4,1,3
2002,2010-11-06,Bolton,Tottenham,4,2,H,2010-11-06,4,2,3,3,1,-1,3,0,3
2003,2010-11-06,Fulham,Aston Villa,1,1,D,2010-11-06,1,1,1,1,0,0,1,1,0
2004,2010-11-06,Man United,Wolves,2,1,H,2010-11-06,2,1,1,1,1,0,3,0,3
2005,2010-11-06,Sunderland,Stoke,2,0,H,2010-11-06,3,0,5,5,-2,-5,3,0,3
2006,2010-11-07,Arsenal,Newcastle,0,1,A,2010-11-13,2,2,1,1,1,1,0,3,-3
2007,2010-11-07,Liverpool,Chelsea,2,0,H,2010-11-13,3,1,3,3,0,-2,3,0,3
2008,2010-11-07,West Brom,Man City,0,2,A,2010-11-13,2,2,5,5,-3,-3,0,3,-3
2009,2010-11-09,Stoke,Birmingham,3,2,H,2010-11-13,5,2,2,2,3,0,6,1,5
2010,2010-11-09,Tottenham,Sunderland,1,1,D,2010-11-13,5,1,3,3,2,-2,4,1,3
2011,2010-11-10,Aston Villa,Blackpool,3,2,H,2010-11-13,5,2,4,4,1,-2,4,1,3
2012,2010-11-10,Chelsea,Fulham,1,0,H,2010-11-13,1,0,2,2,-1,-2,3,1,2
2013,2010-11-10,Everton,Bolton,1,1,D,2010-11-13,1,4,1,1,0,3,1,4,-3
2014,2010-11-10,Man City,Man United,0,0,D,2010-11-13,2,2,0,0,2,2,2,2,0
2015,2010-11-10,Newcastle,Blackburn,1,2,A,2010-11-13,2,4,2,2,0,2,1,3,-2
2016,2010-11-10,West Ham,West Brom,2,2,D,2010-11-13,2,2,2,2,0,0,2,1,1
2017,2010-11-10,Wigan,Liverpool,1,1,D,2010-11-13,2,3,1,1,1,2,4,1,3
2018,2010-11-10,Wolves,Arsenal,0,2,A,2010-11-13,2,2,5,5,-3,-3,0,3,-3
2019,2010-11-13,Aston Villa,Man United,2,2,D,2010-11-13,5,2,4,4,1,-2,4,2,2
2020,2010-11-13,Man City,Birmingham,0,0,D,2010-11-13,2,2,0,0,2,2,2,1,1
2021,2010-11-13,Newcastle,Fulham,0,0,D,2010-11-13,2,0,2,2,0,-2,1,1,0
2022,2010-11-13,Stoke,Liverpool,2,0,H,2010-11-13,5,3,2,2,3,1,6,1,5
2023,2010-11-13,Tottenham,Blackburn,4,2,H,2010-11-13,5,4,3,3,2,1,4,3,1
2024,2010-11-13,West Ham,Blackpool,0,0,D,2010-11-13,2,2,2,2,0,0,2,1,1
2025,2010-11-13,Wigan,West Brom,1,0,H,2010-11-13,2,2,1,1,1,1,4,1,3
2026,2010-11-13,Wolves,Bolton,2,3,A,2010-11-13,2,4,5,5,-3,-1,0,4,-4
2027,2010-11-14,Chelsea,Sunderland,0,3,A,2010-11-20,0,3,4,4,-4,-1,0,3,-3
2028,2010-11-14,Everton,Arsenal,1,2,A,2010-11-20,1,4,2,2,-1,2,0,3,-3
2029,2010-11-20,Arsenal,Tottenham,2,3,A,2010-11-20,4,3,4,4,0,-1,0,3,-3
2030,2010-11-20,Birmingham,Chelsea,1,0,H,2010-11-20,1,0,0,0,1,0,3,0,3
2031,2010-11-20,Blackpool,Wolves,2,1,H,2010-11-20,2,1,1,1,1,0,3,0,3
2032,2010-11-20,Bolton,Newcastle,5,1,H,2010-11-20,5,1,1,1,4,0,3,0,3
2033,2010-11-20,Liverpool,West Ham,3,0,H,2010-11-20,3,0,0,0,3,0,3,0,3
2034,2010-11-20,Man United,Wigan,2,0,H,2010-11-20,2,0,0,0,2,0,3,0,3
2035,2010-11-20,West Brom,Stoke,0,3,A,2010-11-20,0,3,3,3,-3,0,0,3,-3
2036,2010-11-21,Blackburn,Aston Villa,2,0,H,2010-11-27,3,2,7,7,-4,-5,3,0,3
2037,2010-11-21,Fulham,Man City,1,4,A,2010-11-27,2,5,5,5,-3,0,1,4,-3
2038,2010-11-22,Sunderland,Everton,2,2,D,2010-11-27,4,3,5,5,-1,-2,1,1,0
2039,2010-11-27,Aston Villa,Arsenal,2,4,A,2010-11-27,2,4,6,6,-4,-2,0,3,-3
2040,2010-11-27,Bolton,Blackpool,2,2,D,2010-11-27,2,2,2,2,0,0,1,1,0
2041,2010-11-27,Everton,West Brom,1,4,A,2010-11-27,3,4,6,6,-3,-2,0,3,-3
2042,2010-11-27,Fulham,Birmingham,1,1,D,2010-11-27,2,1,5,5,-3,-4,1,1,0
2043,2010-11-27,Man United,Blackburn,7,1,H,2010-11-27,7,3,1,1,6,2,3,0,3
2044,2010-11-27,Stoke,Man City,1,1,D,2010-11-27,1,5,1,1,0,4,1,4,-3
2045,2010-11-27,West Ham,Wigan,3,1,H,2010-11-27,3,1,1,1,2,0,3,0,3
2046,2010-11-27,Wolves,Sunderland,3,2,H,2010-11-27,3,4,2,2,1,2,3,0,3
2047,2010-11-28,Newcastle,Chelsea,1,1,D,2010-12-04,1,2,1,1,0,1,1,1,0
2048,2010-11-28,Tottenham,Liverpool,2,1,H,2010-12-04,3,1,2,2,1,-1,3,0,3
2049,2010-12-04,Arsenal,Fulham,2,1,H,2010-12-04,2,1,1,1,1,0,3,0,3
2050,2010-12-04,Birmingham,Tottenham,1,1,D,2010-12-04,1,3,1,1,0,2,1,1,0
2051,2010-12-04,Blackburn,Wolves,3,0,H,2010-12-04,3,0,0,0,3,0,3,0,3
2052,2010-12-04,Chelsea,Everton,1,1,D,2010-12-04,2,1,2,2,0,-1,1,1,0
2053,2010-12-04,Man City,Bolton,1,0,H,2010-12-04,1,0,0,0,1,0,3,0,3
2054,2010-12-04,Wigan,Stoke,2,2,D,2010-12-04,2,2,2,2,0,0,1,1,0
2055,2010-12-05,Sunderland,West Ham,1,0,H,2010-12-11,1,1,0,0,1,1,3,0,3
2056,2010-12-05,West Brom,Newcastle,3,1,H,2010-12-11,4,4,3,3,1,1,3,0,3
2057,2010-12-06,Liverpool,Aston Villa,3,0,H,2010-12-11,4,2,3,3,1,-1,3,0,3
2058,2010-12-11,Aston Villa,West Brom,2,1,H,2010-12-11,2,4,4,4,-2,0,3,0,3
2059,2010-12-11,Everton,Wigan,0,0,D,2010-12-11,0,0,0,0,0,0,1,1,0
2060,2010-12-11,Fulham,Sunderland,0,0,D,2010-12-11,0,1,0,0,0,1,1,1,0
2061,2010-12-11,Newcastle,Liverpool,3,1,H,2010-12-11,4,4,4,4,0,0,3,0,3
2062,2010-12-11,Stoke,Blackpool,0,1,A,2010-12-11,0,1,1,1,-1,0,0,3,-3
2063,2010-12-11,West Ham,Man City,1,3,A,2010-12-11,1,3,4,4,-3,-1,0,3,-3
2064,2010-12-12,Bolton,Blackburn,2,1,H,2010-12-18,2,2,2,2,0,0,3,0,3
2065,2010-12-12,Tottenham,Chelsea,1,1,D,2010-12-18,1,1,1,1,0,0,1,1,0
2066,2010-12-12,Wolves,Birmingham,1,0,H,2010-12-18,1,0,0,0,1,0,3,0,3
2067,2010-12-13,Man United,Arsenal,1,0,H,2010-12-18,1,0,0,0,1,0,3,0,3
2068,2010-12-18,Blackburn,West Ham,1,1,D,2010-12-18,2,1,3,3,-1,-2,1,1,0
2069,2010-12-18,Sunderland,Bolton,1,0,H,2010-12-18,1,2,0,0,1,2,3,0,3
2070,2010-12-20,Man City,Everton,1,2,A,2010-12-25,1,2,2,2,-1,0,0,3,-3
2071,2010-12-26,Aston Villa,Tottenham,1,2,A,2011-01-01,1,5,6,6,-5,-1,0,3,-3
2072,2010-12-26,Blackburn,Stoke,0,2,A,2011-01-01,3,4,6,6,-3,-2,0,3,-3
2073,2010-12-26,Bolton,West Brom,2,0,H,2011-01-01,3,2,3,3,0,-1,3,0,3
2074,2010-12-26,Fulham,West Ham,1,3,A,2011-01-01,3,6,4,4,-1,2,0,3,-3
2075,2010-12-26,Man United,Sunderland,2,0,H,2011-01-01,5,3,2,2,3,1,3,0,3
2076,2010-12-26,Newcastle,Man City,1,3,A,2011-01-01,1,8,5,5,-4,3,0,3,-3
2077,2010-12-26,Wolves,Wigan,1,2,A,2011-01-01,2,4,4,4,-2,0,0,3,-3
2078,2010-12-27,Arsenal,Chelsea,3,1,H,2011-01-01,8,2,3,3,5,-1,3,0,3
2079,2010-12-28,Birmingham,Man United,1,1,D,2011-01-01,1,5,4,4,-3,1,1,4,-3
2080,2010-12-28,Man City,Aston Villa,4,0,H,2011-01-01,8,1,1,1,7,0,6,0,6
2081,2010-12-28,Stoke,Fulham,0,2,A,2011-01-01,4,3,2,2,2,1,3,3,0
2082,2010-12-28,Sunderland,Blackpool,0,2,A,2011-01-01,3,2,4,4,-1,-2,3,3,0
2083,2010-12-28,Tottenham,Newcastle,2,0,H,2011-01-01,5,1,1,1,4,0,6,0,6
2084,2010-12-28,West Brom,Blackburn,1,3,A,2011-01-01,2,3,7,7,-5,-4,0,3,-3
2085,2010-12-28,West Ham,Everton,1,1,D,2011-01-01,6,1,2,2,4,-1,4,1,3
2086,2010-12-29,Chelsea,Bolton,1,0,H,2011-01-01,2,3,3,3,-1,0,3,0,3
2087,2010-12-29,Liverpool,Wolves,0,1,A,2011-01-01,2,2,2,2,0,0,3,3,0
2088,2010-12-29,Wigan,Arsenal,2,2,D,2011-01-01,4,8,3,3,1,5,1,4,-3
2089,2011-01-01,Birmingham,Arsenal,0,3,A,2011-01-01,1,8,4,4,-3,4,1,4,-3
2090,2011-01-01,Liverpool,Bolton,2,1,H,2011-01-01,2,3,2,2,0,1,3,0,3
2091,2011-01-01,Man City,Blackpool,1,0,H,2011-01-01,8,2,1,1,7,1,6,3,3
2092,2011-01-01,Stoke,Everton,2,0,H,2011-01-01,4,1,2,2,2,-1,3,1,2
2093,2011-01-01,Sunderland,Blackburn,3,0,H,2011-01-01,3,3,4,4,-1,-1,3,3,0
2094,2011-01-01,Tottenham,Fulham,1,0,H,2011-01-01,5,3,1,1,4,2,6,3,3
2095,2011-01-01,West Brom,Man United,1,2,A,2011-01-01,2,5,7,7,-5,-2,0,4,-4
2096,2011-01-01,West Ham,Wolves,2,0,H,2011-01-01,6,2,2,2,4,0,4,3,1
2097,2011-01-02,Chelsea,Aston Villa,3,3,D,2011-01-08,3,3,4,4,-1,-1,1,1,0
2098,2011-01-02,Wigan,Newcastle,0,1,A,2011-01-08,1,6,2,2,-1,4,0,3,-3
2099,2011-01-04,Blackpool,Birmingham,1,2,A,2011-01-08,1,2,2,2,-1,0,0,3,-3
2100,2011-01-04,Fulham,West Brom,3,0,H,2011-01-08,3,0,0,0,3,0,3,0,3
2101,2011-01-04,Man United,Stoke,2,1,H,2011-01-08,2,1,1,1,1,0,3,0,3
2102,2011-01-05,Arsenal,Man City,0,0,D,2011-01-08,0,0,0,0,0,0,1,1,0
2103,2011-01-05,Aston Villa,Sunderland,0,1,A,2011-01-08,3,1,4,4,-1,-3,0,3,-3
2104,2011-01-05,Blackburn,Liverpool,3,1,H,2011-01-08,3,1,1,1,2,0,3,0,3
2105,2011-01-05,Bolton,Wigan,1,1,D,2011-01-08,1,1,1,1,0,0,1,1,0
2106,2011-01-05,Everton,Tottenham,2,1,H,2011-01-08,2,1,1,1,1,0,3,0,3
2107,2011-01-05,Newcastle,West Ham,5,0,H,2011-01-08,6,0,0,0,6,0,3,0,3
2108,2011-01-05,Wolves,Chelsea,1,0,H,2011-01-08,1,3,0,0,1,3,3,0,3
2109,2011-01-12,Blackpool,Liverpool,2,1,H,2011-01-15,4,1,4,4,0,-3,3,0,3
2110,2011-01-15,Chelsea,Blackburn,2,0,H,2011-01-15,2,0,0,0,2,0,3,0,3
2111,2011-01-15,Man City,Wolves,4,3,H,2011-01-15,4,3,3,3,1,0,3,0,3
2112,2011-01-15,Stoke,Bolton,2,0,H,2011-01-15,2,0,0,0,2,0,3,0,3
2113,2011-01-15,West Brom,Blackpool,3,2,H,2011-01-15,3,4,2,2,1,2,3,0,3
2114,2011-01-15,West Ham,Arsenal,0,3,A,2011-01-15,0,3,3,3,-3,0,0,3,-3
2115,2011-01-15,Wigan,Fulham,1,1,D,2011-01-15,1,1,1,1,0,0,1,1,0
2116,2011-01-16,Birmingham,Aston Villa,1,1,D,2011-01-22,1,2,6,6,-5,-4,1,1,0
2117,2011-01-16,Liverpool,Everton,2,2,D,2011-01-22,5,4,2,2,3,2,1,1,0
2118,2011-01-16,Sunderland,Newcastle,1,1,D,2011-01-22,3,2,2,2,1,0,1,1,0
2119,2011-01-16,Tottenham,Man United,0,0,D,2011-01-22,1,5,1,1,0,4,1,1,0
2120,2011-01-22,Arsenal,Wigan,3,0,H,2011-01-22,3,0,0,0,3,0,3,0,3
2121,2011-01-22,Aston Villa,Man City,1,0,H,2011-01-22,2,0,1,1,1,-1,3,0,3
2122,2011-01-22,Blackpool,Sunderland,1,2,A,2011-01-22,1,3,2,2,-1,1,0,3,-3
2123,2011-01-22,Everton,West Ham,2,2,D,2011-01-22,4,2,4,4,0,-2,1,1,0
2124,2011-01-22,Fulham,Stoke,2,0,H,2011-01-22,2,0,0,0,2,0,3,0,3
2125,2011-01-22,Man United,Birmingham,5,0,H,2011-01-22,5,1,0,0,5,1,3,0,3
2126,2011-01-22,Newcastle,Tottenham,1,1,D,2011-01-22,2,1,2,2,0,-1,1,1,0
2127,2011-01-22,Wolves,Liverpool,0,3,A,2011-01-22,0,5,3,3,-3,2,0,3,-3
2128,2011-01-23,Blackburn,West Brom,2,0,H,2011-01-29,2,0,0,0,2,0,3,0,3
2129,2011-01-24,Bolton,Chelsea,0,4,A,2011-01-29,0,4,4,4,-4,0,0,3,-3
2130,2011-01-25,Blackpool,Man United,2,3,A,2011-01-29,2,3,3,3,-1,0,0,3,-3
2131,2011-01-25,Wigan,Aston Villa,1,2,A,2011-01-29,1,2,2,2,-1,0,0,3,-3
2132,2011-01-26,Liverpool,Fulham,1,0,H,2011-01-29,1,0,0,0,1,0,3,0,3
2133,2011-02-01,Arsenal,Everton,2,1,H,2011-02-05,6,6,5,5,1,1,3,0,3
2134,2011-02-01,Man United,Aston Villa,3,1,H,2011-02-05,4,3,3,3,1,0,3,0,3
2135,2011-02-01,Sunderland,Chelsea,2,4,A,2011-02-05,4,4,7,7,-3,-3,0,3,-3
2136,2011-02-01,West Brom,Wigan,2,2,D,2011-02-05,2,6,5,5,-3,1,1,1,0
2137,2011-02-02,Birmingham,Man City,2,2,D,2011-02-05,2,5,2,2,0,3,1,1,0
2138,2011-02-02,Blackburn,Tottenham,0,1,A,2011-02-05,3,3,5,5,-2,-2,0,3,-3
2139,2011-02-02,Blackpool,West Ham,1,3,A,2011-02-05,4,3,8,8,-4,-5,0,3,-3
2140,2011-02-02,Bolton,Wolves,1,0,H,2011-02-05,2,2,2,2,0,0,3,0,3
2141,2011-02-02,Fulham,Newcastle,1,0,H,2011-02-05,3,4,2,2,1,2,3,0,3
2142,2011-02-02,Liverpool,Stoke,2,0,H,2011-02-05,2,3,0,0,2,3,3,0,3
2143,2011-02-05,Aston Villa,Fulham,2,2,D,2011-02-05,3,3,5,5,-2,-2,1,1,0
2144,2011-02-05,Everton,Blackpool,5,3,H,2011-02-05,6,4,5,5,1,-1,3,0,3
2145,2011-02-05,Man City,West Brom,3,0,H,2011-02-05,5,2,2,2,3,0,3,0,3
2146,2011-02-05,Newcastle,Arsenal,4,4,D,2011-02-05,4,6,5,5,-1,1,1,1,0
2147,2011-02-05,Stoke,Sunderland,3,2,H,2011-02-05,3,4,4,4,-1,0,3,0,3
2148,2011-02-05,Tottenham,Bolton,2,1,H,2011-02-05,3,2,1,1,2,1,3,0,3
2149,2011-02-05,Wigan,Blackburn,4,3,H,2011-02-05,6,3,5,5,1,-2,3,0,3
2150,2011-02-05,Wolves,Man United,2,1,H,2011-02-05,2,4,2,2,0,2,3,0,3
2151,2011-02-06,Chelsea,Liverpool,0,1,A,2011-02-12,0,2,1,1,-1,1,0,3,-3
2152,2011-02-06,West Ham,Birmingham,0,1,A,2011-02-12,3,2,4,4,-1,-2,0,3,-3
2153,2011-02-12,Arsenal,Wolves,2,0,H,2011-02-12,2,0,0,0,2,0,3,0,3
2154,2011-02-12,Birmingham,Stoke,1,0,H,2011-02-12,2,0,0,0,2,0,3,0,3
2155,2011-02-12,Blackburn,Newcastle,0,0,D,2011-02-12,0,0,0,0,0,0,1,1,0
2156,2011-02-12,Blackpool,Aston Villa,1,1,D,2011-02-12,1,1,1,1,0,0,1,1,0
2157,2011-02-12,Liverpool,Wigan,1,1,D,2011-02-12,2,1,1,1,1,0,1,1,0
2158,2011-02-12,Man United,Man City,2,1,H,2011-02-12,2,1,1,1,1,0,3,0,3
2159,2011-02-12,Sunderland,Tottenham,1,2,A,2011-02-12,1,2,2,2,-1,0,0,3,-3
2160,2011-02-12,West Brom,West Ham,3,3,D,2011-02-12,3,3,3,3,0,0,1,1,0
2161,2011-02-13,Bolton,Everton,2,0,H,2011-02-19,2,0,0,0,2,0,3,0,3
2162,2011-02-14,Fulham,Chelsea,0,0,D,2011-02-19,0,0,0,0,0,0,1,1,0
2163,2011-02-15,Birmingham,Newcastle,0,2,A,2011-02-19,0,2,2,2,-2,0,0,3,-3
2164,2011-02-20,West Brom,Wolves,1,1,D,2011-02-26,1,5,1,1,0,4,1,1,0
2165,2011-02-22,Blackpool,Tottenham,3,1,H,2011-02-26,3,1,5,5,-2,-4,3,0,3
2166,2011-02-23,Arsenal,Stoke,1,0,H,2011-02-26,1,0,0,0,1,0,3,0,3
2167,2011-02-26,Aston Villa,Blackburn,4,1,H,2011-02-26,4,1,1,1,3,0,3,0,3
2168,2011-02-26,Everton,Sunderland,2,0,H,2011-02-26,2,0,0,0,2,0,3,0,3
2169,2011-02-26,Newcastle,Bolton,1,1,D,2011-02-26,1,1,1,1,0,0,1,1,0
2170,2011-02-26,Wigan,Man United,0,4,A,2011-02-26,0,4,4,4,-4,0,0,3,-3
2171,2011-02-26,Wolves,Blackpool,4,0,H,2011-02-26,5,3,1,1,4,2,3,0,3
2172,2011-02-27,Man City,Fulham,1,1,D,2011-03-05,2,4,1,1,1,3,4,1,3
2173,2011-02-27,West Ham,Liverpool,3,1,H,2011-03-05,6,1,1,1,5,0,6,0,6
2174,2011-02-28,Stoke,West Brom,1,1,D,2011-03-05,1,4,4,4,-3,0,1,4,-3
2175,2011-03-01,Chelsea,Man United,2,1,H,2011-03-05,2,1,1,1,1,0,3,0,3
2176,2011-03-05,Arsenal,Sunderland,0,0,D,2011-03-05,0,0,0,0,0,0,1,1,0
2177,2011-03-05,Birmingham,West Brom,1,3,A,2011-03-05,1,4,3,3,-2,1,0,4,-4
2178,2011-03-05,Bolton,Aston Villa,3,2,H,2011-03-05,3,2,2,2,1,0,3,0,3
2179,2011-03-05,Fulham,Blackburn,3,2,H,2011-03-05,4,2,3,3,1,-1,3,0,3
2180,2011-03-05,Man City,Wigan,1,0,H,2011-03-05,2,0,1,1,1,-1,4,0,4
2181,2011-03-05,Newcastle,Everton,1,2,A,2011-03-05,1,2,2,2,-1,0,0,3,-3
2182,2011-03-05,West Ham,Stoke,3,0,H,2011-03-05,6,1,1,1,5,0,6,0,6
2183,2011-03-06,Liverpool,Man United,3,1,H,2011-03-12,3,1,1,1,2,0,3,0,3
2184,2011-03-06,Wolves,Tottenham,3,3,D,2011-03-12,3,3,3,3,0,0,1,1,0
2185,2011-03-07,Blackpool,Chelsea,1,3,A,2011-03-12,1,3,3,3,-2,0,0,3,-3
2186,2011-03-09,Everton,Birmingham,1,1,D,2011-03-12,1,1,1,1,0,0,1,1,0
2187,2011-03-19,Aston Villa,Wolves,0,1,A,2011-03-19,0,1,1,1,-1,0,0,3,-3
2188,2011-03-19,Blackburn,Blackpool,2,2,D,2011-03-19,2,2,2,2,0,0,1,1,0
2189,2011-03-19,Everton,Fulham,2,1,H,2011-03-19,2,1,1,1,1,0,3,0,3
2190,2011-03-19,Man United,Bolton,1,0,H,2011-03-19,1,0,0,0,1,0,3,0,3
2191,2011-03-19,Stoke,Newcastle,4,0,H,2011-03-19,4,0,0,0,4,0,3,0,3
2192,2011-03-19,Tottenham,West Ham,0,0,D,2011-03-19,0,0,0,0,0,0,1,1,0
2193,2011-03-19,West Brom,Arsenal,2,2,D,2011-03-19,2,2,2,2,0,0,1,1,0
2194,2011-03-19,Wigan,Birmingham,2,1,H,2011-03-19,2,1,1,1,1,0,3,0,3
2195,2011-03-20,Chelsea,Man City,2,0,H,2011-03-26,2,0,0,0,2,0,3,0,3
2196,2011-03-20,Sunderland,Liverpool,0,2,A,2011-03-26,0,2,2,2,-2,0,0,3,-3
2197,2011-04-02,Arsenal,Blackburn,0,0,D,2011-04-02,0,0,0,0,0,0,1,1,0
2198,2011-04-02,Birmingham,Bolton,2,1,H,2011-04-02,2,1,1,1,1,0,3,0,3
2199,2011-04-02,Everton,Aston Villa,2,2,D,2011-04-02,2,2,2,2,0,0,1,1,0
2200,2011-04-02,Newcastle,Wolves,4,1,H,2011-04-02,4,1,1,1,3,0,3,0,3
2201,2011-04-02,Stoke,Chelsea,1,1,D,2011-04-02,1,1,1,1,0,0,1,1,0
2202,2011-04-02,West Brom,Liverpool,2,1,H,2011-04-02,2,1,1,1,1,0,3,0,3
2203,2011-04-02,West Ham,Man United,2,4,A,2011-04-02,2,4,4,4,-2,0,0,3,-3
2204,2011-04-02,Wigan,Tottenham,0,0,D,2011-04-02,0,0,0,0,0,0,1,1,0
2205,2011-04-03,Fulham,Blackpool,3,0,H,2011-04-09,3,0,2,2,1,-2,3,0,3
2206,2011-04-03,Man City,Sunderland,5,0,H,2011-04-09,5,2,0,0,5,2,3,0,3
2207,2011-04-09,Blackburn,Birmingham,1,1,D,2011-04-09,1,1,1,1,0,0,1,1,0
2208,2011-04-09,Bolton,West Ham,3,0,H,2011-04-09,3,0,0,0,3,0,3,0,3
2209,2011-04-09,Chelsea,Wigan,1,0,H,2011-04-09,1,0,0,0,1,0,3,0,3
2210,2011-04-09,Man United,Fulham,2,0,H,2011-04-09,2,3,0,0,2,3,3,0,3
2211,2011-04-09,Sunderland,West Brom,2,3,A,2011-04-09,2,3,8,8,-6,-5,0,3,-3
2212,2011-04-09,Tottenham,Stoke,3,2,H,2011-04-09,3,2,2,2,1,0,3,0,3
2213,2011-04-09,Wolves,Everton,0,3,A,2011-04-09,0,3,3,3,-3,0,0,3,-3
2214,2011-04-10,Aston Villa,Newcastle,1,0,H,2011-04-16,3,0,1,1,2,-1,3,0,3
2215,2011-04-10,Blackpool,Arsenal,1,3,A,2011-04-16,2,3,6,6,-4,-3,0,3,-3
2216,2011-04-11,Liverpool,Man City,3,0,H,2011-04-16,3,0,0,0,3,0,3,0,3
2217,2011-04-16,Birmingham,Sunderland,2,0,H,2011-04-16,2,0,0,0,2,0,3,0,3
2218,2011-04-16,Blackpool,Wigan,1,3,A,2011-04-16,2,3,6,6,-4,-3,0,3,-3
2219,2011-04-16,Everton,Blackburn,2,0,H,2011-04-16,2,0,0,0,2,0,3,0,3
2220,2011-04-16,West Brom,Chelsea,1,3,A,2011-04-16,1,3,3,3,-2,0,0,3,-3
2221,2011-04-16,West Ham,Aston Villa,1,2,A,2011-04-16,1,3,2,2,-1,1,0,3,-3
2222,2011-04-17,Arsenal,Liverpool,1,1,D,2011-04-23,4,6,4,4,0,2,1,1,0
2223,2011-04-19,Newcastle,Man United,0,0,D,2011-04-23,1,1,1,1,0,0,1,1,0
2224,2011-04-20,Chelsea,Birmingham,3,1,H,2011-04-23,6,1,1,1,5,0,6,0,6
2225,2011-04-20,Tottenham,Arsenal,3,3,D,2011-04-23,5,4,5,5,0,-1,2,1,1
2226,2011-04-23,Aston Villa,Stoke,1,1,D,2011-04-23,1,1,1,1,0,0,1,1,0
2227,2011-04-23,Blackpool,Newcastle,1,1,D,2011-04-23,1,1,1,1,0,0,1,1,0
2228,2011-04-23,Chelsea,West Ham,3,0,H,2011-04-23,6,0,1,1,5,-1,6,0,6
2229,2011-04-23,Liverpool,Birmingham,5,0,H,2011-04-23,6,1,1,1,5,0,3,0,3
2230,2011-04-23,Man United,Everton,1,0,H,2011-04-23,1,0,0,0,1,0,3,0,3
2231,2011-04-23,Sunderland,Wigan,4,2,H,2011-04-23,4,2,2,2,2,0,3,0,3
2232,2011-04-23,Tottenham,West Brom,2,2,D,2011-04-23,5,2,5,5,0,-3,2,1,1
2233,2011-04-23,Wolves,Fulham,1,1,D,2011-04-23,1,1,1,1,0,0,1,1,0
2234,2011-04-24,Bolton,Arsenal,2,1,H,2011-04-30,2,1,5,5,-3,-4,3,0,3
2235,2011-04-25,Blackburn,Man City,0,1,A,2011-04-30,1,1,1,1,0,0,3,3,0
2236,2011-04-26,Stoke,Wolves,3,0,H,2011-04-30,3,0,0,0,3,0,3,0,3
2237,2011-04-27,Fulham,Bolton,3,0,H,2011-04-30,6,2,0,0,6,2,3,0,3
2238,2011-04-30,Blackburn,Bolton,1,0,H,2011-04-30,1,2,1,1,0,1,3,0,3
2239,2011-04-30,Blackpool,Stoke,0,0,D,2011-04-30,0,3,0,0,0,3,1,1,0
2240,2011-04-30,Chelsea,Tottenham,2,1,H,2011-04-30,2,1,1,1,1,0,3,0,3
2241,2011-04-30,Sunderland,Fulham,0,3,A,2011-04-30,0,6,3,3,-3,3,0,3,-3
2242,2011-04-30,West Brom,Aston Villa,2,1,H,2011-04-30,2,1,1,1,1,0,3,0,3
2243,2011-04-30,Wigan,Everton,1,1,D,2011-04-30,1,1,1,1,0,0,1,1,0
2244,2011-05-01,Arsenal,Man United,1,0,H,2011-05-07,1,0,0,0,1,0,3,0,3
2245,2011-05-01,Birmingham,Wolves,1,1,D,2011-05-07,2,1,3,3,-1,-2,1,1,0
2246,2011-05-01,Liverpool,Newcastle,3,0,H,2011-05-07,3,2,0,0,3,2,3,0,3
2247,2011-05-01,Man City,West Ham,2,1,H,2011-05-07,3,2,3,3,0,-1,3,0,3
2248,2011-05-07,Aston Villa,Wigan,1,1,D,2011-05-07,1,1,1,1,0,0,1,1,0
2249,2011-05-07,Bolton,Sunderland,1,2,A,2011-05-07,1,2,2,2,-1,0,0,3,-3
2250,2011-05-07,Everton,Man City,2,1,H,2011-05-07,2,3,1,1,1,2,3,0,3
2251,2011-05-07,Newcastle,Birmingham,2,1,H,2011-05-07,2,2,4,4,-2,-2,3,0,3
2252,2011-05-07,Tottenham,Blackpool,1,1,D,2011-05-07,1,1,1,1,0,0,1,1,0
2253,2011-05-07,West Ham,Blackburn,1,1,D,2011-05-07,2,1,3,3,-1,-2,1,1,0
2254,2011-05-08,Man United,Chelsea,2,1,H,2011-05-14,3,1,2,2,1,-1,3,0,3
2255,2011-05-08,Stoke,Arsenal,3,1,H,2011-05-14,3,1,1,1,2,0,3,0,3
2256,2011-05-08,Wolves,West Brom,3,1,H,2011-05-14,6,2,2,2,4,0,3,0,3
2257,2011-05-09,Fulham,Liverpool,2,5,A,2011-05-14,2,5,5,5,-3,0,0,3,-3
2258,2011-05-10,Man City,Tottenham,1,0,H,2011-05-14,1,0,0,0,1,0,3,0,3
2259,2011-05-14,Blackburn,Man United,1,1,D,2011-05-14,1,3,1,1,0,2,1,1,0
2260,2011-05-14,Blackpool,Bolton,4,3,H,2011-05-14,4,3,3,3,1,0,3,0,3
2261,2011-05-14,Sunderland,Wolves,1,3,A,2011-05-14,1,6,3,3,-2,3,0,3,-3
2262,2011-05-14,West Brom,Everton,1,0,H,2011-05-14,2,0,3,3,-1,-3,3,0,3
2263,2011-05-15,Arsenal,Aston Villa,1,2,A,2011-05-21,1,2,2,2,-1,0,0,3,-3
2264,2011-05-15,Birmingham,Fulham,0,2,A,2011-05-21,0,2,2,2,-2,0,0,3,-3
2265,2011-05-15,Chelsea,Newcastle,2,2,D,2011-05-21,2,2,2,2,0,0,1,1,0
2266,2011-05-15,Liverpool,Tottenham,0,2,A,2011-05-21,0,2,2,2,-2,0,0,3,-3
2267,2011-05-15,Wigan,West Ham,3,2,H,2011-05-21,3,2,2,2,1,0,3,0,3
2268,2011-05-17,Man City,Stoke,3,0,H,2011-05-21,3,0,0,0,3,0,3,0,3
2269,2011-05-22,Aston Villa,Liverpool,1,0,H,2011-05-28,1,0,0,0,1,0,3,0,3
2270,2011-05-22,Bolton,Man City,0,2,A,2011-05-28,0,2,2,2,-2,0,0,3,-3
2271,2011-05-22,Everton,Chelsea,1,0,H,2011-05-28,1,0,0,0,1,0,3,0,3
2272,2011-05-22,Fulham,Arsenal,2,2,D,2011-05-28,2,2,2,2,0,0,1,1,0
2273,2011-05-22,Man United,Blackpool,4,2,H,2011-05-28,4,2,2,2,2,0,3,0,3
2274,2011-05-22,Newcastle,West Brom,3,3,D,2011-05-28,3,3,3,3,0,0,1,1,0
2275,2011-05-22,Stoke,Wigan,0,1,A,2011-05-28,0,1,1,1,-1,0,0,3,-3
2276,2011-05-22,Tottenham,Birmingham,2,1,H,2011-05-28,2,1,1,1,1,0,3,0,3
2277,2011-05-22,West Ham,Sunderland,0,3,A,2011-05-28,0,3,3,3,-3,0,0,3,-3
2278,2011-05-22,Wolves,Blackburn,2,3,A,2011-05-28,2,3,3,3,-1,0,0,3,-3
2279,2011-08-13,Blackburn,Wolves,1,2,A,2011-08-13,1,2,2,2,-1,0,0,3,-3
2280,2011-08-13,Fulham,Aston Villa,0,0,D,2011-08-13,0,0,0,0,0,0,1,1,0
2281,2011-08-13,Liverpool,Sunderland,1,1,D,2011-08-13,1,1,1,1,0,0,1,1,0
2282,2011-08-13,Newcastle,Arsenal,0,0,D,2011-08-13,0,0,0,0,0,0,1,1,0
2283,2011-08-13,QPR,Bolton,0,4,A,2011-08-13,0,4,4,4,-4,0,0,3,-3
2284,2011-08-13,Wigan,Norwich,1,1,D,2011-08-13,1,1,1,1,0,0,1,1,0
2285,2011-08-14,Stoke,Chelsea,0,0,D,2011-08-20,0,2,0,0,0,2,1,1,0
2286,2011-08-14,West Brom,Man United,1,2,A,2011-08-20,2,2,4,4,-2,-2,0,3,-3
2287,2011-08-15,Man City,Swansea,4,0,H,2011-08-20,4,0,0,0,4,0,3,0,3
2288,2011-08-20,Arsenal,Liverpool,0,2,A,2011-08-20,0,2,2,2,-2,0,0,3,-3
2289,2011-08-20,Aston Villa,Blackburn,3,1,H,2011-08-20,3,1,1,1,2,0,3,0,3
2290,2011-08-20,Chelsea,West Brom,2,1,H,2011-08-20,2,2,1,1,1,1,3,0,3
2291,2011-08-20,Everton,QPR,0,1,A,2011-08-20,0,1,1,1,-1,0,0,3,-3
2292,2011-08-20,Sunderland,Newcastle,0,1,A,2011-08-20,0,1,1,1,-1,0,0,3,-3
2293,2011-08-20,Swansea,Wigan,0,0,D,2011-08-20,0,0,4,4,-4,-4,1,1,0
2294,2011-08-21,Bolton,Man City,2,3,A,2011-08-27,3,3,6,6,-3,-3,0,3,-3
2295,2011-08-21,Norwich,Stoke,1,1,D,2011-08-27,2,1,4,4,-2,-3,1,1,0
2296,2011-08-21,Wolves,Fulham,2,0,H,2011-08-27,2,0,0,0,2,0,3,0,3
2297,2011-08-22,Man United,Tottenham,3,0,H,2011-08-27,3,0,0,0,3,0,3,0,3
2298,2011-08-27,Aston Villa,Wolves,0,0,D,2011-08-27,0,2,0,0,0,2,1,1,0
2299,2011-08-27,Blackburn,Everton,0,1,A,2011-08-27,0,1,1,1,-1,0,0,3,-3
2300,2011-08-27,Chelsea,Norwich,3,1,H,2011-08-27,3,2,1,1,2,1,3,0,3
2301,2011-08-27,Liverpool,Bolton,3,1,H,2011-08-27,3,3,1,1,2,2,3,0,3
2302,2011-08-27,Swansea,Sunderland,0,0,D,2011-08-27,0,0,0,0,0,0,1,1,0
2303,2011-08-27,Wigan,QPR,2,0,H,2011-08-27,2,0,0,0,2,0,3,0,3
2304,2011-08-28,Man United,Arsenal,8,2,H,2011-09-03,8,2,2,2,6,0,3,0,3
2305,2011-08-28,Newcastle,Fulham,2,1,H,2011-09-03,2,1,1,1,1,0,3,0,3
2306,2011-08-28,Tottenham,Man City,1,5,A,2011-09-03,1,5,5,5,-4,0,0,3,-3
2307,2011-08-28,West Brom,Stoke,0,1,A,2011-09-03,0,1,1,1,-1,0,0,3,-3
2308,2011-09-10,Arsenal,Swansea,1,0,H,2011-09-10,1,0,0,0,1,0,3,0,3
2309,2011-09-10,Bolton,Man United,0,5,A,2011-09-10,0,5,5,5,-5,0,0,3,-3
2310,2011-09-10,Everton,Aston Villa,2,2,D,2011-09-10,2,2,2,2,0,0,1,1,0
2311,2011-09-10,Man City,Wigan,3,0,H,2011-09-10,3,0,0,0,3,0,3,0,3
2312,2011-09-10,Stoke,Liverpool,1,0,H,2011-09-10,1,0,0,0,1,0,3,0,3
2313,2011-09-10,Sunderland,Chelsea,1,2,A,2011-09-10,1,2,2,2,-1,0,0,3,-3
2314,2011-09-10,Wolves,Tottenham,0,2,A,2011-09-10,0,2,2,2,-2,0,0,3,-3
2315,2011-09-11,Fulham,Blackburn,1,1,D,2011-09-17,1,5,1,1,0,4,1,1,0
2316,2011-09-11,Norwich,West Brom,0,1,A,2011-09-17,2,1,2,2,0,-1,0,3,-3
2317,2011-09-12,QPR,Newcastle,0,0,D,2011-09-17,3,1,0,0,3,1,1,2,-1
2318,2011-09-17,Aston Villa,Newcastle,1,1,D,2011-09-17,1,1,1,1,0,0,1,2,-1
2319,2011-09-17,Blackburn,Arsenal,4,3,H,2011-09-17,5,3,4,4,1,-1,3,0,3
2320,2011-09-17,Bolton,Norwich,1,2,A,2011-09-17,1,2,2,2,-1,0,0,3,-3
2321,2011-09-17,Everton,Wigan,3,1,H,2011-09-17,3,1,1,1,2,0,3,0,3
2322,2011-09-17,Swansea,West Brom,3,0,H,2011-09-17,3,1,0,0,3,1,3,3,0
2323,2011-09-17,Wolves,QPR,0,3,A,2011-09-17,0,3,3,3,-3,0,0,3,-3
2324,2011-09-18,Fulham,Man City,2,2,D,2011-09-24,2,4,2,2,0,2,1,1,0
2325,2011-09-18,Man United,Chelsea,3,1,H,2011-09-24,4,5,2,2,2,3,3,0,3
2326,2011-09-18,Sunderland,Stoke,4,0,H,2011-09-24,4,1,0,0,4,1,3,0,3
2327,2011-09-18,Tottenham,Liverpool,4,0,H,2011-09-24,6,2,1,1,5,1,3,0,3
2328,2011-09-24,Arsenal,Bolton,3,0,H,2011-09-24,3,0,0,0,3,0,3,0,3
2329,2011-09-24,Chelsea,Swansea,4,1,H,2011-09-24,5,1,4,4,1,-3,3,0,3
2330,2011-09-24,Liverpool,Wolves,2,1,H,2011-09-24,2,1,5,5,-3,-4,3,0,3
2331,2011-09-24,Man City,Everton,2,0,H,2011-09-24,4,0,2,2,2,-2,3,0,3
2332,2011-09-24,Newcastle,Blackburn,3,1,H,2011-09-24,3,1,1,1,2,0,3,0,3
2333,2011-09-24,Stoke,Man United,1,1,D,2011-09-24,1,4,5,5,-4,-1,1,1,0
2334,2011-09-24,West Brom,Fulham,0,0,D,2011-09-24,0,2,0,0,0,2,1,1,0
2335,2011-09-24,Wigan,Tottenham,1,2,A,2011-09-24,1,6,2,2,-1,4,0,3,-3
2336,2011-09-25,QPR,Aston Villa,1,1,D,2011-10-01,1,3,1,1,0,2,1,1,0
2337,2011-09-26,Norwich,Sunderland,2,1,H,2011-10-01,2,3,3,3,-1,0,3,0,3
2338,2011-10-01,Aston Villa,Wigan,2,0,H,2011-10-01,3,0,1,1,2,-1,3,0,3
2339,2011-10-01,Blackburn,Man City,0,4,A,2011-10-01,0,4,4,4,-4,0,0,3,-3
2340,2011-10-01,Everton,Liverpool,0,2,A,2011-10-01,0,2,2,2,-2,0,0,3,-3
2341,2011-10-01,Man United,Norwich,2,0,H,2011-10-01,2,2,0,0,2,2,3,0,3
2342,2011-10-01,Sunderland,West Brom,2,2,D,2011-10-01,3,2,4,4,-1,-2,1,1,0
2343,2011-10-01,Wolves,Newcastle,1,2,A,2011-10-01,1,2,2,2,-1,0,0,3,-3
2344,2011-10-02,Bolton,Chelsea,1,5,A,2011-10-08,1,5,5,5,-4,0,0,3,-3
2345,2011-10-02,Fulham,QPR,6,0,H,2011-10-08,6,0,0,0,6,0,3,0,3
2346,2011-10-02,Swansea,Stoke,2,0,H,2011-10-08,2,0,0,0,2,0,3,0,3
2347,2011-10-02,Tottenham,Arsenal,2,1,H,2011-10-08,2,1,1,1,1,0,3,0,3
2348,2011-10-15,Chelsea,Everton,3,1,H,2011-10-15,3,1,1,1,2,0,3,0,3
2349,2011-10-15,Liverpool,Man United,1,1,D,2011-10-15,1,1,1,1,0,0,1,1,0
2350,2011-10-15,Man City,Aston Villa,4,1,H,2011-10-15,4,1,1,1,3,0,3,0,3
2351,2011-10-15,Norwich,Swansea,3,1,H,2011-10-15,3,1,1,1,2,0,3,0,3
2352,2011-10-15,QPR,Blackburn,1,1,D,2011-10-15,1,1,1,1,0,0,1,1,0
2353,2011-10-15,Stoke,Fulham,2,0,H,2011-10-15,2,0,0,0,2,0,3,0,3
2354,2011-10-15,Wigan,Bolton,1,3,A,2011-10-15,1,3,3,3,-2,0,0,3,-3
2355,2011-10-16,Arsenal,Sunderland,2,1,H,2011-10-22,2,3,1,1,1,2,3,3,0
2356,2011-10-16,Newcastle,Tottenham,2,2,D,2011-10-22,3,2,2,2,1,0,4,1,3
2357,2011-10-16,West Brom,Wolves,2,0,H,2011-10-22,4,2,1,1,3,1,3,0,3
2358,2011-10-22,Aston Villa,West Brom,1,2,A,2011-10-22,1,4,2,2,-1,2,0,3,-3
2359,2011-10-22,Bolton,Sunderland,0,2,A,2011-10-22,0,3,2,2,-2,1,0,3,-3
2360,2011-10-22,Liverpool,Norwich,1,1,D,2011-10-22,1,1,1,1,0,0,1,1,0
2361,2011-10-22,Newcastle,Wigan,1,0,H,2011-10-22,3,0,2,2,1,-2,4,0,4
2362,2011-10-22,Wolves,Swansea,2,2,D,2011-10-22,2,2,4,4,-2,-2,1,1,0
2363,2011-10-23,Arsenal,Stoke,3,1,H,2011-10-29,8,1,4,4,4,-3,3,0,3
2364,2011-10-23,Blackburn,Tottenham,1,2,A,2011-10-29,4,2,5,5,-1,-3,0,3,-3
2365,2011-10-23,Fulham,Everton,1,3,A,2011-10-29,3,3,3,3,0,0,0,3,-3
2366,2011-10-23,Man United,Man City,1,6,A,2011-10-29,2,9,6,6,-4,3,0,3,-3
2367,2011-10-23,QPR,Chelsea,1,0,H,2011-10-29,1,3,0,0,1,3,3,0,3
2368,2011-10-29,Chelsea,Arsenal,3,5,A,2011-10-29,3,8,6,6,-3,2,0,3,-3
2369,2011-10-29,Everton,Man United,0,1,A,2011-10-29,3,2,2,2,1,0,0,3,-3
2370,2011-10-29,Man City,Wolves,3,1,H,2011-10-29,9,1,2,2,7,-1,3,0,3
2371,2011-10-29,Norwich,Blackburn,3,3,D,2011-10-29,3,4,3,3,0,1,1,1,0
2372,2011-10-29,Sunderland,Aston Villa,2,2,D,2011-10-29,2,2,2,2,0,0,1,1,0
2373,2011-10-29,Swansea,Bolton,3,1,H,2011-10-29,3,1,1,1,2,0,3,0,3
2374,2011-10-29,West Brom,Liverpool,0,2,A,2011-10-29,0,2,2,2,-2,0,0,3,-3
2375,2011-10-29,Wigan,Fulham,0,2,A,2011-10-29,0,3,2,2,-2,1,0,3,-3
2376,2011-10-30,Tottenham,QPR,3,1,H,2011-11-05,3,3,1,1,2,2,3,0,3
2377,2011-10-31,Stoke,Newcastle,1,3,A,2011-11-05,1,5,3,3,-2,2,0,3,-3
2378,2011-11-05,Arsenal,West Brom,3,0,H,2011-11-05,3,0,0,0,3,0,3,0,3
2379,2011-11-05,Aston Villa,Norwich,3,2,H,2011-11-05,3,2,2,2,1,0,3,0,3
2380,2011-11-05,Blackburn,Chelsea,0,1,A,2011-11-05,0,1,1,1,-1,0,0,3,-3
2381,2011-11-05,Liverpool,Swansea,0,0,D,2011-11-05,0,0,0,0,0,0,1,1,0
2382,2011-11-05,Man United,Sunderland,1,0,H,2011-11-05,1,0,0,0,1,0,3,0,3
2383,2011-11-05,Newcastle,Everton,2,1,H,2011-11-05,5,1,2,2,3,-1,3,0,3
2384,2011-11-05,QPR,Man City,2,3,A,2011-11-05,3,3,6,6,-3,-3,0,3,-3
2385,2011-11-06,Bolton,Stoke,5,0,H,2011-11-12,5,0,0,0,5,0,3,0,3
2386,2011-11-06,Fulham,Tottenham,1,3,A,2011-11-12,1,3,3,3,-2,0,0,3,-3
2387,2011-11-06,Wolves,Wigan,3,1,H,2011-11-12,3,1,1,1,2,0,3,0,3
2388,2011-11-19,Everton,Wolves,2,1,H,2011-11-19,2,1,1,1,1,0,3,0,3
2389,2011-11-19,Man City,Newcastle,3,1,H,2011-11-19,3,1,1,1,2,0,3,0,3
2390,2011-11-19,Norwich,Arsenal,1,2,A,2011-11-19,1,2,2,2,-1,0,0,3,-3
2391,2011-11-19,Stoke,QPR,2,3,A,2011-11-19,2,3,3,3,-1,0,0,3,-3
2392,2011-11-19,Sunderland,Fulham,0,0,D,2011-11-19,0,0,0,0,0,0,1,1,0
2393,2011-11-19,Swansea,Man United,0,1,A,2011-11-19,0,1,1,1,-1,0,0,3,-3
2394,2011-11-19,West Brom,Bolton,2,1,H,2011-11-19,2,1,1,1,1,0,3,0,3
2395,2011-11-19,Wigan,Blackburn,3,3,D,2011-11-19,3,3,3,3,0,0,1,1,0
2396,2011-11-20,Chelsea,Liverpool,1,2,A,2011-11-26,4,2,2,2,2,0,3,3,0
2397,2011-11-21,Tottenham,Aston Villa,2,0,H,2011-11-26,5,0,1,1,4,-1,3,0,3
2398,2011-11-26,Arsenal,Fulham,1,1,D,2011-11-26,1,1,1,1,0,0,1,1,0
2399,2011-11-26,Bolton,Everton,0,2,A,2011-11-26,0,2,2,2,-2,0,0,3,-3
2400,2011-11-26,Chelsea,Wolves,3,0,H,2011-11-26,4,0,2,2,2,-2,3,0,3
2401,2011-11-26,Man United,Newcastle,1,1,D,2011-11-26,1,1,1,1,0,0,1,1,0
2402,2011-11-26,Norwich,QPR,2,1,H,2011-11-26,2,1,1,1,1,0,3,0,3
2403,2011-11-26,Stoke,Blackburn,3,1,H,2011-11-26,3,1,1,1,2,0,3,0,3
2404,2011-11-26,Sunderland,Wigan,1,2,A,2011-11-26,1,2,2,2,-1,0,0,3,-3
2405,2011-11-26,West Brom,Tottenham,1,3,A,2011-11-26,1,5,3,3,-2,2,0,3,-3
2406,2011-11-27,Liverpool,Man City,1,1,D,2011-12-03,1,6,1,1,0,5,1,1,0
2407,2011-11-27,Swansea,Aston Villa,0,0,D,2011-12-03,2,0,4,4,-2,-4,1,1,0
2408,2011-12-03,Aston Villa,Man United,0,1,A,2011-12-03,0,1,1,1,-1,0,0,3,-3
2409,2011-12-03,Blackburn,Swansea,4,2,H,2011-12-03,4,2,2,2,2,0,3,0,3
2410,2011-12-03,Man City,Norwich,5,1,H,2011-12-03,6,1,2,2,4,-1,3,0,3
2411,2011-12-03,Newcastle,Chelsea,0,3,A,2011-12-03,0,3,3,3,-3,0,0,3,-3
2412,2011-12-03,QPR,West Brom,1,1,D,2011-12-03,1,1,1,1,0,0,1,1,0
2413,2011-12-03,Tottenham,Bolton,3,0,H,2011-12-03,3,0,0,0,3,0,3,0,3
2414,2011-12-03,Wigan,Arsenal,0,4,A,2011-12-03,0,4,4,4,-4,0,0,3,-3
2415,2011-12-04,Everton,Stoke,0,1,A,2011-12-10,0,1,2,2,-2,-1,0,3,-3
2416,2011-12-04,Wolves,Sunderland,2,1,H,2011-12-10,3,1,5,5,-2,-4,3,0,3
2417,2011-12-05,Fulham,Liverpool,1,0,H,2011-12-10,1,1,2,2,-1,-1,3,0,3
2418,2011-12-10,Arsenal,Everton,1,0,H,2011-12-10,1,0,0,0,1,0,3,0,3
2419,2011-12-10,Bolton,Aston Villa,1,2,A,2011-12-10,1,2,2,2,-1,0,0,3,-3
2420,2011-12-10,Liverpool,QPR,1,0,H,2011-12-10,1,0,1,1,0,-1,3,0,3
2421,2011-12-10,Man United,Wolves,4,1,H,2011-12-10,4,3,1,1,3,2,3,0,3
2422,2011-12-10,Norwich,Newcastle,4,2,H,2011-12-10,4,2,2,2,2,0,3,0,3
2423,2011-12-10,Swansea,Fulham,2,0,H,2011-12-10,2,1,0,0,2,1,3,0,3
2424,2011-12-10,West Brom,Wigan,1,2,A,2011-12-10,1,2,2,2,-1,0,0,3,-3
2425,2011-12-11,Stoke,Tottenham,2,1,H,2011-12-17,4,1,2,2,2,-1,3,0,3
2426,2011-12-11,Sunderland,Blackburn,2,1,H,2011-12-17,2,2,1,1,1,1,3,0,3
2427,2011-12-12,Chelsea,Man City,2,1,H,2011-12-17,3,1,2,2,1,-1,3,0,3
2428,2011-12-17,Blackburn,West Brom,1,2,A,2011-12-17,2,2,4,4,-2,-2,0,3,-3
2429,2011-12-17,Everton,Norwich,1,1,D,2011-12-17,1,1,1,1,0,0,1,1,0
2430,2011-12-17,Fulham,Bolton,2,0,H,2011-12-17,2,0,0,0,2,0,3,0,3
2431,2011-12-17,Newcastle,Swansea,0,0,D,2011-12-17,0,0,0,0,0,0,1,1,0
2432,2011-12-17,Wigan,Chelsea,1,1,D,2011-12-17,1,3,1,1,0,2,1,1,0
2433,2011-12-17,Wolves,Stoke,1,2,A,2011-12-17,1,4,2,2,-1,2,0,3,-3
2434,2011-12-18,Aston Villa,Liverpool,0,2,A,2011-12-24,1,2,4,4,-3,-2,0,4,-4
2435,2011-12-18,Man City,Arsenal,1,0,H,2011-12-24,4,2,0,0,4,2,6,3,3
2436,2011-12-18,QPR,Man United,0,2,A,2011-12-24,2,7,5,5,-3,2,0,6,-6
2437,2011-12-18,Tottenham,Sunderland,1,0,H,2011-12-24,2,3,1,1,1,2,4,3,1
2438,2011-12-20,Blackburn,Bolton,1,2,A,2011-12-24,1,2,2,2,-1,0,0,3,-3
2439,2011-12-20,Wolves,Norwich,2,2,D,2011-12-24,2,2,2,2,0,0,1,1,0
2440,2011-12-21,Aston Villa,Arsenal,1,2,A,2011-12-24,1,2,4,4,-3,-2,0,3,-3
2441,2011-12-21,Everton,Swansea,1,0,H,2011-12-24,1,0,0,0,1,0,3,0,3
2442,2011-12-21,Fulham,Man United,0,5,A,2011-12-24,0,7,5,5,-5,2,0,6,-6
2443,2011-12-21,Man City,Stoke,3,0,H,2011-12-24,4,0,0,0,4,0,6,0,6
2444,2011-12-21,Newcastle,West Brom,2,3,A,2011-12-24,2,3,3,3,-1,0,0,3,-3
2445,2011-12-21,QPR,Sunderland,2,3,A,2011-12-24,2,3,5,5,-3,-2,0,3,-3
2446,2011-12-21,Wigan,Liverpool,0,0,D,2011-12-24,0,2,0,0,0,2,1,4,-3
2447,2011-12-22,Tottenham,Chelsea,1,1,D,2011-12-24,2,1,1,1,1,0,4,1,3
2448,2011-12-26,Bolton,Newcastle,0,2,A,2011-12-31,1,3,3,3,-2,0,1,3,-2
2449,2011-12-26,Chelsea,Fulham,1,1,D,2011-12-31,2,2,4,4,-2,-2,1,2,-1
2450,2011-12-26,Liverpool,Blackburn,1,1,D,2011-12-31,4,4,2,2,2,2,4,4,0
2451,2011-12-26,Man United,Wigan,5,0,H,2011-12-31,7,2,3,3,4,-1,3,1,2
2452,2011-12-26,Stoke,Aston Villa,0,0,D,2011-12-31,2,3,2,2,0,1,2,4,-2
2453,2011-12-26,Sunderland,Everton,1,1,D,2011-12-31,1,1,1,1,0,0,1,1,0
2454,2011-12-26,West Brom,Man City,0,0,D,2011-12-31,0,0,0,0,0,0,1,1,0
2455,2011-12-27,Arsenal,Wolves,1,1,D,2011-12-31,2,2,1,1,1,1,4,2,2
2456,2011-12-27,Norwich,Tottenham,0,2,A,2011-12-31,1,3,3,3,-2,0,1,4,-3
2457,2011-12-27,Swansea,QPR,1,1,D,2011-12-31,2,1,2,2,0,-1,2,1,1
2458,2011-12-30,Liverpool,Newcastle,3,1,H,2011-12-31,4,3,2,2,2,1,4,3,1
2459,2011-12-31,Arsenal,QPR,1,0,H,2011-12-31,2,1,1,1,1,0,4,1,3
2460,2011-12-31,Bolton,Wolves,1,1,D,2011-12-31,1,2,3,3,-2,-1,1,2,-1
2461,2011-12-31,Chelsea,Aston Villa,1,3,A,2011-12-31,2,3,4,4,-2,-1,1,4,-3
2462,2011-12-31,Man United,Blackburn,2,3,A,2011-12-31,7,4,3,3,4,1,3,4,-1
2463,2011-12-31,Norwich,Fulham,1,1,D,2011-12-31,1,2,3,3,-2,-1,1,2,-1
2464,2011-12-31,Stoke,Wigan,2,2,D,2011-12-31,2,2,2,2,0,0,2,1,1
2465,2011-12-31,Swansea,Tottenham,1,1,D,2011-12-31,2,3,2,2,0,1,2,4,-2
2466,2012-01-01,Sunderland,Man City,1,0,H,2012-01-07,5,3,1,1,4,2,3,0,3
2467,2012-01-01,West Brom,Everton,0,1,A,2012-01-07,0,2,2,2,-2,0,0,3,-3
2468,2012-01-02,Aston Villa,Swansea,0,2,A,2012-01-07,0,2,2,2,-2,0,0,3,-3
2469,2012-01-02,Blackburn,Stoke,1,2,A,2012-01-07,1,2,2,2,-1,0,0,3,-3
2470,2012-01-02,Fulham,Arsenal,2,1,H,2012-01-07,2,1,1,1,1,0,3,0,3
2471,2012-01-02,QPR,Norwich,1,2,A,2012-01-07,1,2,2,2,-1,0,0,3,-3
2472,2012-01-02,Wolves,Chelsea,1,2,A,2012-01-07,1,2,2,2,-1,0,0,3,-3
2473,2012-01-03,Man City,Liverpool,3,0,H,2012-01-07,3,0,1,1,2,-1,3,0,3
2474,2012-01-03,Tottenham,West Brom,1,0,H,2012-01-07,1,0,0,0,1,0,3,0,3
2475,2012-01-03,Wigan,Sunderland,1,4,A,2012-01-07,1,5,4,4,-3,1,0,3,-3
2476,2012-01-04,Everton,Bolton,1,2,A,2012-01-07,2,2,2,2,0,0,0,3,-3
2477,2012-01-04,Newcastle,Man United,3,0,H,2012-01-07,3,0,0,0,3,0,3,0,3
2478,2012-01-11,Tottenham,Everton,2,0,H,2012-01-14,3,1,1,1,2,0,4,1,3
2479,2012-01-14,Aston Villa,Everton,1,1,D,2012-01-14,1,1,1,1,0,0,1,1,0
2480,2012-01-14,Blackburn,Fulham,3,1,H,2012-01-14,3,1,1,1,2,0,3,0,3
2481,2012-01-14,Chelsea,Sunderland,1,0,H,2012-01-14,1,0,0,0,1,0,3,0,3
2482,2012-01-14,Liverpool,Stoke,0,0,D,2012-01-14,0,0,0,0,0,0,1,1,0
2483,2012-01-14,Man United,Bolton,3,0,H,2012-01-14,3,0,0,0,3,0,3,0,3
2484,2012-01-14,Tottenham,Wolves,1,1,D,2012-01-14,3,1,1,1,2,0,4,1,3
2485,2012-01-14,West Brom,Norwich,1,2,A,2012-01-14,1,2,2,2,-1,0,0,3,-3
2486,2012-01-15,Newcastle,QPR,1,0,H,2012-01-21,3,3,5,5,-2,-2,3,0,3
2487,2012-01-15,Swansea,Arsenal,3,2,H,2012-01-21,3,2,4,4,-1,-2,3,0,3
2488,2012-01-16,Wigan,Man City,0,1,A,2012-01-21,1,1,4,4,-3,-3,0,3,-3
2489,2012-01-21,Bolton,Liverpool,3,1,H,2012-01-21,3,1,1,1,2,0,3,0,3
2490,2012-01-21,Everton,Blackburn,1,1,D,2012-01-21,1,1,1,1,0,0,1,1,0
2491,2012-01-21,Fulham,Newcastle,5,2,H,2012-01-21,5,3,2,2,3,1,3,0,3
2492,2012-01-21,Norwich,Chelsea,0,0,D,2012-01-21,0,0,0,0,0,0,1,1,0
2493,2012-01-21,QPR,Wigan,3,1,H,2012-01-21,3,1,2,2,1,-1,3,0,3
2494,2012-01-21,Stoke,West Brom,1,2,A,2012-01-21,1,2,2,2,-1,0,0,3,-3
2495,2012-01-21,Sunderland,Swansea,2,0,H,2012-01-21,2,3,0,0,2,3,3,0,3
2496,2012-01-21,Wolves,Aston Villa,2,3,A,2012-01-21,2,3,3,3,-1,0,0,3,-3
2497,2012-01-22,Arsenal,Man United,1,2,A,2012-01-28,1,2,2,2,-1,0,0,3,-3
2498,2012-01-22,Man City,Tottenham,3,2,H,2012-01-28,3,2,2,2,1,0,3,0,3
2499,2012-01-31,Everton,Man City,1,0,H,2012-02-04,2,3,1,1,1,2,3,0,3
2500,2012-01-31,Man United,Stoke,2,0,H,2012-02-04,2,0,0,0,2,0,3,0,3
2501,2012-01-31,Swansea,Chelsea,1,1,D,2012-02-04,3,1,2,2,1,-1,1,1,0
2502,2012-01-31,Tottenham,Wigan,3,1,H,2012-02-04,3,2,1,1,2,1,3,0,3
2503,2012-01-31,Wolves,Liverpool,0,3,A,2012-02-04,2,3,4,4,-2,-1,0,3,-3
2504,2012-02-01,Aston Villa,QPR,2,2,D,2012-02-04,2,3,2,2,0,1,1,1,0
2505,2012-02-01,Blackburn,Newcastle,0,2,A,2012-02-04,1,2,9,9,-8,-7,0,3,-3
2506,2012-02-01,Bolton,Arsenal,0,0,D,2012-02-04,0,7,2,2,-2,5,1,1,0
2507,2012-02-01,Fulham,West Brom,1,1,D,2012-02-04,1,2,4,4,-3,-2,1,1,0
2508,2012-02-01,Sunderland,Norwich,3,0,H,2012-02-04,4,2,0,0,4,2,3,0,3
2509,2012-02-04,Arsenal,Blackburn,7,1,H,2012-02-04,7,1,1,1,6,0,3,0,3
2510,2012-02-04,Man City,Fulham,3,0,H,2012-02-04,3,1,1,1,2,0,3,0,3
2511,2012-02-04,Norwich,Bolton,2,0,H,2012-02-04,2,0,3,3,-1,-3,3,0,3
2512,2012-02-04,QPR,Wolves,1,2,A,2012-02-04,3,2,4,4,-1,-2,0,3,-3
2513,2012-02-04,Stoke,Sunderland,0,1,A,2012-02-04,0,4,3,3,-3,1,0,3,-3
2514,2012-02-04,West Brom,Swansea,1,2,A,2012-02-04,2,3,3,3,-1,0,0,3,-3
2515,2012-02-04,Wigan,Everton,1,1,D,2012-02-04,2,2,4,4,-2,-2,1,1,0
2516,2012-02-05,Chelsea,Man United,3,3,D,2012-02-11,3,5,5,5,-2,0,1,1,0
2517,2012-02-05,Newcastle,Aston Villa,2,1,H,2012-02-11,2,1,6,6,-4,-5,3,0,3
2518,2012-02-06,Liverpool,Tottenham,0,0,D,2012-02-11,1,5,2,2,-1,3,1,1,0
2519,2012-02-11,Blackburn,QPR,3,2,H,2012-02-11,3,2,2,2,1,0,3,0,3
2520,2012-02-11,Bolton,Wigan,1,2,A,2012-02-11,1,2,2,2,-1,0,0,3,-3
2521,2012-02-11,Everton,Chelsea,2,0,H,2012-02-11,2,3,0,0,2,3,3,0,3
2522,2012-02-11,Fulham,Stoke,2,1,H,2012-02-11,2,1,1,1,1,0,3,0,3
2523,2012-02-11,Man United,Liverpool,2,1,H,2012-02-11,5,1,4,4,1,-3,3,0,3
2524,2012-02-11,Sunderland,Arsenal,1,2,A,2012-02-11,1,2,2,2,-1,0,0,3,-3
2525,2012-02-11,Swansea,Norwich,2,3,A,2012-02-11,2,3,3,3,-1,0,0,3,-3
2526,2012-02-11,Tottenham,Newcastle,5,0,H,2012-02-11,5,2,0,0,5,2,3,0,3
2527,2012-02-12,Aston Villa,Man City,0,1,A,2012-02-18,0,1,1,1,-1,0,0,3,-3
2528,2012-02-12,Wolves,West Brom,1,5,A,2012-02-18,1,5,5,5,-4,0,0,3,-3
2529,2012-02-25,Chelsea,Bolton,3,0,H,2012-02-25,3,0,0,0,3,0,3,0,3
2530,2012-02-25,Man City,Blackburn,3,0,H,2012-02-25,3,0,0,0,3,0,3,0,3
2531,2012-02-25,Newcastle,Wolves,2,2,D,2012-02-25,2,2,2,2,0,0,1,1,0
2532,2012-02-25,QPR,Fulham,0,1,A,2012-02-25,0,1,1,1,-1,0,0,3,-3
2533,2012-02-25,West Brom,Sunderland,4,0,H,2012-02-25,4,0,0,0,4,0,3,0,3
2534,2012-02-25,Wigan,Aston Villa,0,0,D,2012-02-25,0,0,0,0,0,0,1,1,0
2535,2012-02-26,Arsenal,Tottenham,5,2,H,2012-03-03,7,2,3,3,4,-1,3,0,3
2536,2012-02-26,Norwich,Man United,1,2,A,2012-03-03,1,2,3,3,-2,-1,0,3,-3
2537,2012-02-26,Stoke,Swansea,2,0,H,2012-03-03,3,2,0,0,3,2,6,3,3
2538,2012-03-03,Blackburn,Aston Villa,1,1,D,2012-03-03,1,1,1,1,0,0,1,1,0
2539,2012-03-03,Liverpool,Arsenal,1,2,A,2012-03-03,1,7,2,2,-1,5,0,3,-3
2540,2012-03-03,Man City,Bolton,2,0,H,2012-03-03,2,0,0,0,2,0,3,0,3
2541,2012-03-03,QPR,Everton,1,1,D,2012-03-03,1,1,1,1,0,0,1,1,0
2542,2012-03-03,Stoke,Norwich,1,0,H,2012-03-03,3,1,0,0,3,1,6,0,6
2543,2012-03-03,West Brom,Chelsea,1,0,H,2012-03-03,1,0,0,0,1,0,3,0,3
2544,2012-03-03,Wigan,Swansea,0,2,A,2012-03-03,0,2,2,2,-2,0,0,3,-3
2545,2012-03-04,Fulham,Wolves,5,0,H,2012-03-10,5,0,1,1,4,-1,3,0,3
2546,2012-03-04,Newcastle,Sunderland,1,1,D,2012-03-10,1,2,1,1,0,1,1,1,0
2547,2012-03-04,Tottenham,Man United,1,3,A,2012-03-10,1,3,4,4,-3,-1,0,3,-3
2548,2012-03-10,Aston Villa,Fulham,1,0,H,2012-03-10,1,5,0,0,1,5,3,0,3
2549,2012-03-10,Bolton,QPR,2,1,H,2012-03-10,2,1,1,1,1,0,3,0,3
2550,2012-03-10,Chelsea,Stoke,1,0,H,2012-03-10,1,0,0,0,1,0,3,0,3
2551,2012-03-10,Everton,Tottenham,1,0,H,2012-03-10,1,1,0,0,1,1,3,0,3
2552,2012-03-10,Sunderland,Liverpool,1,0,H,2012-03-10,2,0,1,1,1,-1,3,0,3
2553,2012-03-10,Wolves,Blackburn,0,2,A,2012-03-10,0,2,7,7,-7,-5,0,3,-3
2554,2012-03-11,Man United,West Brom,2,0,H,2012-03-17,2,1,0,0,2,1,3,1,2
2555,2012-03-11,Norwich,Wigan,1,1,D,2012-03-17,1,2,1,1,0,1,1,1,0
2556,2012-03-11,Swansea,Man City,1,0,H,2012-03-17,4,0,0,0,4,0,3,0,3
2557,2012-03-12,Arsenal,Newcastle,2,1,H,2012-03-17,2,1,1,1,1,0,3,0,3
2558,2012-03-13,Liverpool,Everton,3,0,H,2012-03-17,3,0,0,0,3,0,3,0,3
2559,2012-03-17,Fulham,Swansea,0,3,A,2012-03-17,0,4,3,3,-3,1,0,3,-3
2560,2012-03-17,Wigan,West Brom,1,1,D,2012-03-17,2,1,2,2,0,-1,1,1,0
2561,2012-03-18,Newcastle,Norwich,1,0,H,2012-03-24,1,2,0,0,1,2,3,0,3
2562,2012-03-18,Wolves,Man United,0,5,A,2012-03-24,1,5,7,7,-6,-2,0,3,-3
2563,2012-03-20,Blackburn,Sunderland,2,0,H,2012-03-24,3,3,2,2,1,1,3,0,3
2564,2012-03-21,Everton,Arsenal,0,1,A,2012-03-24,2,4,1,1,1,3,0,3,-3
2565,2012-03-21,Man City,Chelsea,2,1,H,2012-03-24,3,1,2,2,1,-1,3,0,3
2566,2012-03-21,QPR,Liverpool,3,2,H,2012-03-24,4,3,5,5,-1,-2,3,0,3
2567,2012-03-21,Tottenham,Stoke,1,1,D,2012-03-24,1,2,1,1,0,1,1,1,0
2568,2012-03-24,Arsenal,Aston Villa,3,0,H,2012-03-24,4,0,0,0,4,0,3,0,3
2569,2012-03-24,Bolton,Blackburn,2,1,H,2012-03-24,2,3,1,1,1,2,3,0,3
2570,2012-03-24,Chelsea,Tottenham,0,0,D,2012-03-24,1,1,2,2,-1,-1,1,1,0
2571,2012-03-24,Liverpool,Wigan,1,2,A,2012-03-24,3,2,5,5,-2,-3,0,3,-3
2572,2012-03-24,Norwich,Wolves,2,1,H,2012-03-24,2,1,2,2,0,-1,3,0,3
2573,2012-03-24,Stoke,Man City,1,1,D,2012-03-24,2,3,2,2,0,1,1,1,0
2574,2012-03-24,Sunderland,QPR,3,1,H,2012-03-24,3,4,3,3,0,1,3,0,3
2575,2012-03-24,Swansea,Everton,0,2,A,2012-03-24,0,2,2,2,-2,0,0,3,-3
2576,2012-03-25,West Brom,Newcastle,1,3,A,2012-03-31,1,3,5,5,-4,-2,0,3,-3
2577,2012-03-26,Man United,Fulham,1,0,H,2012-03-31,1,2,0,0,1,2,3,0,3
2578,2012-03-31,Aston Villa,Chelsea,2,4,A,2012-03-31,2,4,4,4,-2,0,0,3,-3
2579,2012-03-31,Everton,West Brom,2,0,H,2012-03-31,2,1,0,0,2,1,3,0,3
2580,2012-03-31,Fulham,Norwich,2,1,H,2012-03-31,2,1,2,2,0,-1,3,0,3
2581,2012-03-31,Man City,Sunderland,3,3,D,2012-03-31,3,3,3,3,0,0,1,1,0
2582,2012-03-31,QPR,Arsenal,2,1,H,2012-03-31,2,1,1,1,1,0,3,0,3
2583,2012-03-31,Wigan,Stoke,2,0,H,2012-03-31,2,0,0,0,2,0,3,0,3
2584,2012-03-31,Wolves,Bolton,2,3,A,2012-03-31,2,3,3,3,-1,0,0,3,-3
2585,2012-04-01,Newcastle,Liverpool,2,0,H,2012-04-07,4,1,0,0,4,1,3,0,3
2586,2012-04-01,Tottenham,Swansea,3,1,H,2012-04-07,3,1,1,1,2,0,3,0,3
2587,2012-04-02,Blackburn,Man United,0,2,A,2012-04-07,0,2,5,5,-5,-3,0,3,-3
2588,2012-04-06,Swansea,Newcastle,0,2,A,2012-04-07,1,4,5,5,-4,-1,0,3,-3
2589,2012-04-07,Bolton,Fulham,0,3,A,2012-04-07,0,3,3,3,-3,0,0,3,-3
2590,2012-04-07,Chelsea,Wigan,2,1,H,2012-04-07,2,1,1,1,1,0,3,0,3
2591,2012-04-07,Liverpool,Aston Villa,1,1,D,2012-04-07,1,1,3,3,-2,-2,1,1,0
2592,2012-04-07,Norwich,Everton,2,2,D,2012-04-07,2,2,2,2,0,0,1,1,0
2593,2012-04-07,Stoke,Wolves,2,1,H,2012-04-07,2,1,1,1,1,0,3,0,3
2594,2012-04-07,Sunderland,Tottenham,0,0,D,2012-04-07,0,3,0,0,0,3,1,1,0
2595,2012-04-07,West Brom,Blackburn,3,0,H,2012-04-07,3,0,0,0,3,0,3,0,3
2596,2012-04-08,Arsenal,Man City,1,0,H,2012-04-14,4,10,0,0,4,10,3,3,0
2597,2012-04-08,Man United,QPR,2,0,H,2012-04-14,2,3,1,1,1,2,3,0,3
2598,2012-04-09,Aston Villa,Stoke,1,1,D,2012-04-14,1,1,1,1,0,0,1,1,0
2599,2012-04-09,Everton,Sunderland,4,0,H,2012-04-14,4,0,0,0,4,0,3,0,3
2600,2012-04-09,Fulham,Chelsea,1,1,D,2012-04-14,1,1,1,1,0,0,1,1,0
2601,2012-04-09,Newcastle,Bolton,2,0,H,2012-04-14,2,0,0,0,2,0,3,0,3
2602,2012-04-09,Tottenham,Norwich,1,2,A,2012-04-14,1,3,2,2,-1,1,0,3,-3
2603,2012-04-10,Blackburn,Liverpool,2,3,A,2012-04-14,2,3,6,6,-4,-3,0,3,-3
2604,2012-04-11,Man City,West Brom,4,0,H,2012-04-14,10,1,2,2,8,-1,3,0,3
2605,2012-04-11,QPR,Swansea,3,0,H,2012-04-14,3,3,3,3,0,0,3,0,3
2606,2012-04-11,Wigan,Man United,1,0,H,2012-04-14,1,2,0,0,1,2,3,0,3
2607,2012-04-11,Wolves,Arsenal,0,3,A,2012-04-14,0,4,3,3,-3,1,0,3,-3
2608,2012-04-14,Norwich,Man City,1,6,A,2012-04-14,3,10,7,7,-4,3,0,3,-3
2609,2012-04-14,Sunderland,Wolves,0,0,D,2012-04-14,0,0,4,4,-4,-4,1,1,0
2610,2012-04-14,Swansea,Blackburn,3,0,H,2012-04-14,3,2,3,3,0,-1,3,0,3
2611,2012-04-14,West Brom,QPR,1,0,H,2012-04-14,1,3,4,4,-3,-1,3,0,3
2612,2012-04-15,Man United,Aston Villa,4,0,H,2012-04-21,4,0,0,0,4,0,3,0,3
2613,2012-04-16,Arsenal,Wigan,1,2,A,2012-04-21,1,3,2,2,-1,1,1,3,-2
2614,2012-04-21,Arsenal,Chelsea,0,0,D,2012-04-21,1,0,2,2,-1,-2,1,1,0
2615,2012-04-21,Aston Villa,Sunderland,0,0,D,2012-04-21,0,0,4,4,-4,-4,1,1,0
2616,2012-04-21,Blackburn,Norwich,2,0,H,2012-04-21,2,0,0,0,2,0,3,0,3
2617,2012-04-21,Bolton,Swansea,1,1,D,2012-04-21,1,1,1,1,0,0,1,1,0
2618,2012-04-21,Fulham,Wigan,2,1,H,2012-04-21,2,3,1,1,1,2,3,3,0
2619,2012-04-21,Newcastle,Stoke,3,0,H,2012-04-21,3,0,0,0,3,0,3,0,3
2620,2012-04-21,QPR,Tottenham,1,0,H,2012-04-21,1,0,0,0,1,0,3,0,3
2621,2012-04-22,Liverpool,West Brom,0,1,A,2012-04-28,3,1,1,1,2,0,0,3,-3
2622,2012-04-22,Man United,Everton,4,4,D,2012-04-28,4,8,4,4,0,4,1,1,0
2623,2012-04-22,Wolves,Man City,0,2,A,2012-04-28,4,2,6,6,-2,-4,0,3,-3
2624,2012-04-24,Aston Villa,Bolton,1,2,A,2012-04-28,1,4,2,2,-1,2,0,4,-4
2625,2012-04-28,Everton,Fulham,4,0,H,2012-04-28,8,0,4,4,4,-4,3,0,3
2626,2012-04-28,Norwich,Liverpool,0,3,A,2012-04-28,0,3,3,3,-3,0,0,3,-3
2627,2012-04-28,Stoke,Arsenal,1,1,D,2012-04-28,1,1,1,1,0,0,1,1,0
2628,2012-04-28,Sunderland,Bolton,2,2,D,2012-04-28,2,4,2,2,0,2,1,4,-3
2629,2012-04-28,Swansea,Wolves,4,4,D,2012-04-28,4,4,4,4,0,0,1,1,0
2630,2012-04-28,West Brom,Aston Villa,0,0,D,2012-04-28,1,1,0,0,1,1,1,1,0
2631,2012-04-28,Wigan,Newcastle,4,0,H,2012-04-28,4,0,0,0,4,0,3,0,3
2632,2012-04-29,Chelsea,QPR,6,1,H,2012-05-05,6,1,3,3,3,-2,3,0,3
2633,2012-04-29,Tottenham,Blackburn,2,0,H,2012-05-05,6,0,1,1,5,-1,3,0,3
2634,2012-04-30,Man City,Man United,1,0,H,2012-05-05,1,0,0,0,1,0,3,0,3
2635,2012-05-01,Liverpool,Fulham,0,1,A,2012-05-05,0,1,1,1,-1,0,0,3,-3
2636,2012-05-01,Stoke,Everton,1,1,D,2012-05-05,1,1,1,1,0,0,1,1,0
2637,2012-05-02,Bolton,Tottenham,1,4,A,2012-05-05,1,6,4,4,-3,2,0,3,-3
2638,2012-05-02,Chelsea,Newcastle,0,2,A,2012-05-05,6,2,3,3,3,-1,3,3,0
2639,2012-05-05,Arsenal,Norwich,3,3,D,2012-05-05,3,3,3,3,0,0,1,1,0
2640,2012-05-06,Aston Villa,Tottenham,1,1,D,2012-05-12,1,1,1,1,0,0,1,1,0
2641,2012-05-06,Bolton,West Brom,2,2,D,2012-05-12,2,2,2,2,0,0,1,1,0
2642,2012-05-06,Fulham,Sunderland,2,1,H,2012-05-12,2,1,1,1,1,0,3,0,3
2643,2012-05-06,Man United,Swansea,2,0,H,2012-05-12,2,0,0,0,2,0,3,0,3
2644,2012-05-06,Newcastle,Man City,0,2,A,2012-05-12,0,2,2,2,-2,0,0,3,-3
2645,2012-05-06,QPR,Stoke,1,0,H,2012-05-12,1,0,0,0,1,0,3,0,3
2646,2012-05-06,Wolves,Everton,0,0,D,2012-05-12,0,0,0,0,0,0,1,1,0
2647,2012-05-07,Blackburn,Wigan,0,1,A,2012-05-12,0,1,1,1,-1,0,0,3,-3
2648,2012-05-08,Liverpool,Chelsea,4,1,H,2012-05-12,4,1,1,1,3,0,3,0,3
2649,2012-05-13,Chelsea,Blackburn,2,1,H,2012-05-19,2,1,1,1,1,0,3,0,3
2650,2012-05-13,Everton,Newcastle,3,1,H,2012-05-19,3,1,1,1,2,0,3,0,3
2651,2012-05-13,Man City,QPR,3,2,H,2012-05-19,3,2,2,2,1,0,3,0,3
2652,2012-05-13,Norwich,Aston Villa,2,0,H,2012-05-19,2,0,0,0,2,0,3,0,3
2653,2012-05-13,Stoke,Bolton,2,2,D,2012-05-19,2,2,2,2,0,0,1,1,0
2654,2012-05-13,Sunderland,Man United,0,1,A,2012-05-19,0,1,1,1,-1,0,0,3,-3
2655,2012-05-13,Swansea,Liverpool,1,0,H,2012-05-19,1,0,0,0,1,0,3,0,3
2656,2012-05-13,Tottenham,Fulham,2,0,H,2012-05-19,2,0,0,0,2,0,3,0,3
2657,2012-05-13,West Brom,Arsenal,2,3,A,2012-05-19,2,3,3,3,-1,0,0,3,-3
2658,2012-05-13,Wigan,Wolves,3,2,H,2012-05-19,3,2,2,2,1,0,3,0,3
2659,2012-08-18,Arsenal,Sunderland,0,0,D,2012-08-18,0,0,0,0,0,0,1,1,0
2660,2012-08-18,Fulham,Norwich,5,0,H,2012-08-18,5,0,0,0,5,0,3,0,3
2661,2012-08-18,Newcastle,Tottenham,2,1,H,2012-08-18,2,1,1,1,1,0,3,0,3
2662,2012-08-18,QPR,Swansea,0,5,A,2012-08-18,0,5,5,5,-5,0,0,3,-3
2663,2012-08-18,Reading,Stoke,1,1,D,2012-08-18,1,1,1,1,0,0,1,1,0
2664,2012-08-18,West Brom,Liverpool,3,0,H,2012-08-18,3,0,0,0,3,0,3,0,3
2665,2012-08-18,West Ham,Aston Villa,1,0,H,2012-08-18,1,0,0,0,1,0,3,0,3
2666,2012-08-19,Man City,Southampton,3,2,H,2012-08-25,3,2,2,2,1,0,3,0,3
2667,2012-08-19,Wigan,Chelsea,0,2,A,2012-08-25,2,8,2,2,0,6,0,3,-3
2668,2012-08-20,Everton,Man United,1,0,H,2012-08-25,4,3,1,1,3,2,3,0,3
2669,2012-08-22,Chelsea,Reading,4,2,H,2012-08-25,8,2,2,2,6,0,6,0,6
2670,2012-08-25,Aston Villa,Everton,1,3,A,2012-08-25,1,4,3,3,-2,1,0,3,-3
2671,2012-08-25,Chelsea,Newcastle,2,0,H,2012-08-25,8,0,2,2,6,-2,6,0,6
2672,2012-08-25,Man United,Fulham,3,2,H,2012-08-25,3,2,3,3,0,-1,3,0,3
2673,2012-08-25,Norwich,QPR,1,1,D,2012-08-25,1,1,1,1,0,0,1,1,0
2674,2012-08-25,Southampton,Wigan,0,2,A,2012-08-25,2,2,5,5,-3,-3,0,3,-3
2675,2012-08-25,Swansea,West Ham,3,0,H,2012-08-25,3,0,0,0,3,0,3,0,3
2676,2012-08-25,Tottenham,West Brom,1,1,D,2012-08-25,1,1,1,1,0,0,1,1,0
2677,2012-08-26,Liverpool,Man City,2,2,D,2012-09-01,2,5,2,2,0,3,1,1,0
2678,2012-08-26,Stoke,Arsenal,0,0,D,2012-09-01,2,0,2,2,0,-2,1,1,0
2679,2012-09-01,Man City,QPR,3,1,H,2012-09-01,5,1,3,3,2,-2,3,0,3
2680,2012-09-01,Swansea,Sunderland,2,2,D,2012-09-01,2,2,2,2,0,0,1,1,0
2681,2012-09-01,Tottenham,Norwich,1,1,D,2012-09-01,1,1,1,1,0,0,1,1,0
2682,2012-09-01,West Brom,Everton,2,0,H,2012-09-01,2,0,0,0,2,0,3,0,3
2683,2012-09-01,West Ham,Fulham,3,0,H,2012-09-01,3,0,0,0,3,0,3,0,3
2684,2012-09-01,Wigan,Stoke,2,2,D,2012-09-01,2,2,2,2,0,0,1,1,0
2685,2012-09-02,Liverpool,Arsenal,0,2,A,2012-09-08,0,2,2,2,-2,0,0,3,-3
2686,2012-09-02,Newcastle,Aston Villa,1,1,D,2012-09-08,1,1,1,1,0,0,1,1,0
2687,2012-09-02,Southampton,Man United,2,3,A,2012-09-08,2,3,3,3,-1,0,0,3,-3
2688,2012-09-15,Arsenal,Southampton,6,1,H,2012-09-15,6,1,1,1,5,0,3,0,3
2689,2012-09-15,Aston Villa,Swansea,2,0,H,2012-09-15,2,0,0,0,2,0,3,0,3
2690,2012-09-15,Fulham,West Brom,3,0,H,2012-09-15,3,0,0,0,3,0,3,0,3
2691,2012-09-15,Man United,Wigan,4,0,H,2012-09-15,4,0,0,0,4,0,3,0,3
2692,2012-09-15,Norwich,West Ham,0,0,D,2012-09-15,0,0,0,0,0,0,1,1,0
2693,2012-09-15,QPR,Chelsea,0,0,D,2012-09-15,0,0,0,0,0,0,1,1,0
2694,2012-09-15,Stoke,Man City,1,1,D,2012-09-15,1,1,1,1,0,0,1,1,0
2695,2012-09-15,Sunderland,Liverpool,1,1,D,2012-09-15,1,1,1,1,0,0,1,1,0
2696,2012-09-16,Reading,Tottenham,1,3,A,2012-09-22,1,3,4,4,-3,-1,0,3,-3
2697,2012-09-17,Everton,Newcastle,2,2,D,2012-09-22,5,2,2,2,3,0,1,1,0
2698,2012-09-22,Chelsea,Stoke,1,0,H,2012-09-22,1,0,0,0,1,0,3,0,3
2699,2012-09-22,Southampton,Aston Villa,4,1,H,2012-09-22,4,1,1,1,3,0,3,0,3
2700,2012-09-22,Swansea,Everton,0,3,A,2012-09-22,0,5,3,3,-3,2,0,3,-3
2701,2012-09-22,West Brom,Reading,1,0,H,2012-09-22,1,1,0,0,1,1,3,0,3
2702,2012-09-22,West Ham,Sunderland,1,1,D,2012-09-22,1,1,1,1,0,0,1,1,0
2703,2012-09-22,Wigan,Fulham,1,2,A,2012-09-22,1,2,2,2,-1,0,0,3,-3
2704,2012-09-23,Liverpool,Man United,1,2,A,2012-09-29,6,4,4,4,2,0,0,3,-3
2705,2012-09-23,Man City,Arsenal,1,1,D,2012-09-29,3,2,2,2,1,0,1,1,0
2706,2012-09-23,Newcastle,Norwich,1,0,H,2012-09-29,3,2,2,2,1,0,3,0,3
2707,2012-09-23,Tottenham,QPR,2,1,H,2012-09-29,5,1,3,3,2,-2,3,0,3
2708,2012-09-29,Arsenal,Chelsea,1,2,A,2012-09-29,2,2,3,3,-1,-1,0,3,-3
2709,2012-09-29,Everton,Southampton,3,1,H,2012-09-29,3,1,1,1,2,0,3,0,3
2710,2012-09-29,Fulham,Man City,1,2,A,2012-09-29,1,3,2,2,-1,1,0,3,-3
2711,2012-09-29,Man United,Tottenham,2,3,A,2012-09-29,4,5,4,4,0,1,0,3,-3
2712,2012-09-29,Norwich,Liverpool,2,5,A,2012-09-29,2,6,6,6,-4,0,0,3,-3
2713,2012-09-29,Reading,Newcastle,2,2,D,2012-09-29,2,3,2,2,0,1,1,1,0
2714,2012-09-29,Stoke,Swansea,2,0,H,2012-09-29,2,0,0,0,2,0,3,0,3
2715,2012-09-29,Sunderland,Wigan,1,0,H,2012-09-29,1,0,0,0,1,0,3,0,3
2716,2012-09-30,Aston Villa,West Brom,1,1,D,2012-10-06,1,4,1,1,0,3,1,1,0
2717,2012-10-01,QPR,West Ham,1,2,A,2012-10-06,3,3,5,5,-2,-2,0,3,-3
2718,2012-10-06,Chelsea,Norwich,4,1,H,2012-10-06,4,1,1,1,3,0,3,0,3
2719,2012-10-06,Man City,Sunderland,3,0,H,2012-10-06,3,0,0,0,3,0,3,0,3
2720,2012-10-06,Swansea,Reading,2,2,D,2012-10-06,2,2,2,2,0,0,1,1,0
2721,2012-10-06,West Brom,QPR,3,2,H,2012-10-06,4,3,3,3,1,0,3,0,3
2722,2012-10-06,West Ham,Arsenal,1,3,A,2012-10-06,3,3,4,4,-1,-1,0,3,-3
2723,2012-10-06,Wigan,Everton,2,2,D,2012-10-06,2,2,2,2,0,0,1,1,0
2724,2012-10-07,Liverpool,Stoke,0,0,D,2012-10-13,0,0,0,0,0,0,1,1,0
2725,2012-10-07,Newcastle,Man United,0,3,A,2012-10-13,0,3,3,3,-3,0,0,3,-3
2726,2012-10-07,Southampton,Fulham,2,2,D,2012-10-13,2,2,2,2,0,0,1,1,0
2727,2012-10-07,Tottenham,Aston Villa,2,0,H,2012-10-13,2,0,0,0,2,0,3,0,3
2728,2012-10-20,Fulham,Aston Villa,1,0,H,2012-10-20,1,0,0,0,1,0,3,0,3
2729,2012-10-20,Liverpool,Reading,1,0,H,2012-10-20,1,0,0,0,1,0,3,0,3
2730,2012-10-20,Man United,Stoke,4,2,H,2012-10-20,4,2,2,2,2,0,3,0,3
2731,2012-10-20,Norwich,Arsenal,1,0,H,2012-10-20,1,0,0,0,1,0,3,0,3
2732,2012-10-20,Swansea,Wigan,2,1,H,2012-10-20,2,1,1,1,1,0,3,0,3
2733,2012-10-20,Tottenham,Chelsea,2,4,A,2012-10-20,2,4,4,4,-2,0,0,3,-3
2734,2012-10-20,West Brom,Man City,1,2,A,2012-10-20,1,2,2,2,-1,0,0,3,-3
2735,2012-10-20,West Ham,Southampton,4,1,H,2012-10-20,4,1,1,1,3,0,3,0,3
2736,2012-10-21,QPR,Everton,1,1,D,2012-10-27,1,1,2,2,-1,-1,1,1,0
2737,2012-10-21,Sunderland,Newcastle,1,1,D,2012-10-27,1,1,1,1,0,0,1,1,0
2738,2012-10-27,Arsenal,QPR,1,0,H,2012-10-27,1,1,0,0,1,1,3,0,3
2739,2012-10-27,Aston Villa,Norwich,1,1,D,2012-10-27,1,1,1,1,0,0,1,1,0
2740,2012-10-27,Man City,Swansea,1,0,H,2012-10-27,1,0,0,0,1,0,3,0,3
2741,2012-10-27,Reading,Fulham,3,3,D,2012-10-27,3,3,3,3,0,0,1,1,0
2742,2012-10-27,Stoke,Sunderland,0,0,D,2012-10-27,0,1,0,0,0,1,1,1,0
2743,2012-10-27,Wigan,West Ham,2,1,H,2012-10-27,2,1,1,1,1,0,3,0,3
2744,2012-10-28,Chelsea,Man United,2,3,A,2012-11-03,3,5,4,4,-1,1,0,3,-3
2745,2012-10-28,Everton,Liverpool,2,2,D,2012-11-03,4,2,4,4,0,-2,1,1,0
2746,2012-10-28,Newcastle,West Brom,2,1,H,2012-11-03,2,1,1,1,1,0,3,0,3
2747,2012-10-28,Southampton,Tottenham,1,2,A,2012-11-03,1,2,2,2,-1,0,0,3,-3
2748,2012-11-03,Fulham,Everton,2,2,D,2012-11-03,2,4,2,2,0,2,1,1,0
2749,2012-11-03,Man United,Arsenal,2,1,H,2012-11-03,5,1,3,3,2,-2,3,0,3
2750,2012-11-03,Norwich,Stoke,1,0,H,2012-11-03,1,0,0,0,1,0,3,0,3
2751,2012-11-03,Sunderland,Aston Villa,0,1,A,2012-11-03,0,1,1,1,-1,0,0,3,-3
2752,2012-11-03,Swansea,Chelsea,1,1,D,2012-11-03,1,3,1,1,0,2,1,1,0
2753,2012-11-03,Tottenham,Wigan,0,1,A,2012-11-03,2,1,2,2,0,-1,0,3,-3
2754,2012-11-03,West Ham,Man City,0,0,D,2012-11-03,0,0,0,0,0,0,1,1,0
2755,2012-11-04,Liverpool,Newcastle,1,1,D,2012-11-10,1,1,1,1,0,0,1,1,0
2756,2012-11-04,QPR,Reading,1,1,D,2012-11-10,1,1,2,2,-1,-1,1,1,0
2757,2012-11-05,West Brom,Southampton,2,0,H,2012-11-10,4,1,1,1,3,0,3,0,3
2758,2012-11-10,Arsenal,Fulham,3,3,D,2012-11-10,3,3,3,3,0,0,1,1,0
2759,2012-11-10,Aston Villa,Man United,2,3,A,2012-11-10,2,3,3,3,-1,0,0,3,-3
2760,2012-11-10,Everton,Sunderland,2,1,H,2012-11-10,2,1,1,1,1,0,3,0,3
2761,2012-11-10,Reading,Norwich,0,0,D,2012-11-10,1,0,1,1,0,-1,1,1,0
2762,2012-11-10,Southampton,Swansea,1,1,D,2012-11-10,1,1,3,3,-2,-2,1,1,0
2763,2012-11-10,Stoke,QPR,1,0,H,2012-11-10,1,1,0,0,1,1,3,0,3
2764,2012-11-10,Wigan,West Brom,1,2,A,2012-11-10,1,4,2,2,-1,2,0,3,-3
2765,2012-11-11,Chelsea,Liverpool,1,1,D,2012-11-17,2,4,3,3,-1,1,1,1,0
2766,2012-11-11,Man City,Tottenham,2,1,H,2012-11-17,7,3,1,1,6,2,6,0,6
2767,2012-11-11,Newcastle,West Ham,0,1,A,2012-11-17,1,1,3,3,-2,-2,0,3,-3
2768,2012-11-17,Arsenal,Tottenham,5,2,H,2012-11-17,5,3,2,2,3,1,3,0,3
2769,2012-11-17,Liverpool,Wigan,3,0,H,2012-11-17,4,0,1,1,3,-1,3,0,3
2770,2012-11-17,Man City,Aston Villa,5,0,H,2012-11-17,7,0,1,1,6,-1,6,0,6
2771,2012-11-17,Newcastle,Swansea,1,2,A,2012-11-17,1,2,3,3,-2,-1,0,3,-3
2772,2012-11-17,Norwich,Man United,1,0,H,2012-11-17,1,0,0,0,1,0,3,0,3
2773,2012-11-17,QPR,Southampton,1,3,A,2012-11-17,1,3,3,3,-2,0,0,3,-3
2774,2012-11-17,Reading,Everton,2,1,H,2012-11-17,2,1,1,1,1,0,3,0,3
2775,2012-11-17,West Brom,Chelsea,2,1,H,2012-11-17,2,2,1,1,1,1,3,0,3
2776,2012-11-18,Fulham,Sunderland,1,3,A,2012-11-24,1,5,4,4,-3,1,0,3,-3
2777,2012-11-19,West Ham,Stoke,1,1,D,2012-11-24,1,2,1,1,0,1,1,1,0
2778,2012-11-24,Aston Villa,Arsenal,0,0,D,2012-11-24,0,0,0,0,0,0,1,1,0
2779,2012-11-24,Everton,Norwich,1,1,D,2012-11-24,1,1,1,1,0,0,1,1,0
2780,2012-11-24,Man United,QPR,3,1,H,2012-11-24,3,1,1,1,2,0,3,0,3
2781,2012-11-24,Stoke,Fulham,1,0,H,2012-11-24,2,1,1,1,1,0,3,0,3
2782,2012-11-24,Sunderland,West Brom,2,4,A,2012-11-24,5,4,5,5,0,-1,0,3,-3
2783,2012-11-24,Wigan,Reading,3,2,H,2012-11-24,3,2,2,2,1,0,3,0,3
2784,2012-11-25,Chelsea,Man City,0,0,D,2012-12-01,1,3,3,3,-2,0,2,4,-2
2785,2012-11-25,Southampton,Newcastle,2,0,H,2012-12-01,3,1,2,2,1,-1,4,0,4
2786,2012-11-25,Swansea,Liverpool,0,0,D,2012-12-01,5,2,1,1,4,1,4,1,3
2787,2012-11-25,Tottenham,West Ham,3,1,H,2012-12-01,8,4,2,2,6,2,6,0,6
2788,2012-11-27,Aston Villa,Reading,1,0,H,2012-12-01,2,3,1,1,1,2,3,0,3
2789,2012-11-27,Sunderland,QPR,0,0,D,2012-12-01,0,1,0,0,0,1,1,1,0
2790,2012-11-28,Chelsea,Fulham,0,0,D,2012-12-01,1,0,3,3,-2,-3,2,1,1
2791,2012-11-28,Everton,Arsenal,1,1,D,2012-12-01,2,1,2,2,0,-1,1,1,0
2792,2012-11-28,Man United,West Ham,1,0,H,2012-12-01,5,4,3,3,2,1,3,0,3
2793,2012-11-28,Southampton,Norwich,1,1,D,2012-12-01,3,1,2,2,1,-1,4,1,3
2794,2012-11-28,Stoke,Newcastle,2,1,H,2012-12-01,3,1,1,1,2,0,3,0,3
2795,2012-11-28,Swansea,West Brom,3,1,H,2012-12-01,5,1,1,1,4,0,4,0,4
2796,2012-11-28,Tottenham,Liverpool,2,1,H,2012-12-01,8,2,2,2,6,0,6,1,5
2797,2012-11-28,Wigan,Man City,0,2,A,2012-12-01,0,3,2,2,-2,1,0,4,-4
2798,2012-12-01,Arsenal,Swansea,0,2,A,2012-12-01,1,5,3,3,-2,2,0,3,-3
2799,2012-12-01,Fulham,Tottenham,0,3,A,2012-12-01,0,8,3,3,-3,5,0,3,-3
2800,2012-12-01,Liverpool,Southampton,1,0,H,2012-12-01,2,3,2,2,0,1,3,0,3
2801,2012-12-01,Man City,Everton,1,1,D,2012-12-01,3,2,1,1,2,1,1,1,0
2802,2012-12-01,QPR,Aston Villa,1,1,D,2012-12-01,1,2,1,1,0,1,1,1,0
2803,2012-12-01,Reading,Man United,3,4,A,2012-12-01,3,5,5,5,-2,0,0,3,-3
2804,2012-12-01,West Brom,Stoke,0,1,A,2012-12-01,1,3,4,4,-3,-1,0,3,-3
2805,2012-12-01,West Ham,Chelsea,3,1,H,2012-12-01,4,1,5,5,-1,-4,3,0,3
2806,2012-12-02,Norwich,Sunderland,2,1,H,2012-12-08,6,2,4,4,2,-2,3,0,3
2807,2012-12-03,Newcastle,Wigan,3,0,H,2012-12-08,3,2,0,0,3,2,3,0,3
2808,2012-12-08,Arsenal,West Brom,2,0,H,2012-12-08,2,0,0,0,2,0,3,0,3
2809,2012-12-08,Aston Villa,Stoke,0,0,D,2012-12-08,0,0,0,0,0,0,1,1,0
2810,2012-12-08,Southampton,Reading,1,0,H,2012-12-08,1,0,0,0,1,0,3,0,3
2811,2012-12-08,Sunderland,Chelsea,1,3,A,2012-12-08,2,3,5,5,-3,-2,0,3,-3
2812,2012-12-08,Swansea,Norwich,3,4,A,2012-12-08,3,6,4,4,-1,2,0,3,-3
2813,2012-12-08,Wigan,QPR,2,2,D,2012-12-08,2,2,5,5,-3,-3,1,1,0
2814,2012-12-09,Everton,Tottenham,2,1,H,2012-12-15,3,1,2,2,1,-1,3,0,3
2815,2012-12-09,Man City,Man United,2,3,A,2012-12-15,5,6,4,4,1,2,0,3,-3
2816,2012-12-09,West Ham,Liverpool,2,3,A,2012-12-15,2,4,3,3,-1,1,0,3,-3
2817,2012-12-10,Fulham,Newcastle,2,1,H,2012-12-15,3,2,3,3,0,-1,3,0,3
2818,2012-12-11,Sunderland,Reading,3,0,H,2012-12-15,4,0,3,3,1,-3,3,0,3
2819,2012-12-15,Liverpool,Aston Villa,1,3,A,2012-12-15,4,3,5,5,-1,-2,0,3,-3
2820,2012-12-15,Man United,Sunderland,3,1,H,2012-12-15,6,4,3,3,3,1,3,0,3
2821,2012-12-15,Newcastle,Man City,1,3,A,2012-12-15,2,5,5,5,-3,0,0,3,-3
2822,2012-12-15,Norwich,Wigan,2,1,H,2012-12-15,2,1,1,1,1,0,3,0,3
2823,2012-12-15,QPR,Fulham,2,1,H,2012-12-15,2,3,1,1,1,2,3,0,3
2824,2012-12-15,Stoke,Everton,1,1,D,2012-12-15,1,3,1,1,0,2,1,1,0
2825,2012-12-16,Tottenham,Swansea,1,0,H,2012-12-22,1,0,0,0,1,0,4,0,4
2826,2012-12-16,West Brom,West Ham,0,0,D,2012-12-22,2,1,1,1,1,0,4,1,3
2827,2012-12-17,Reading,Arsenal,2,5,A,2012-12-22,2,6,6,6,-4,0,0,6,-6
2828,2012-12-22,Liverpool,Fulham,4,0,H,2012-12-22,4,0,0,0,4,0,3,0,3
2829,2012-12-22,Man City,Reading,1,0,H,2012-12-22,1,2,0,0,1,2,3,0,3
2830,2012-12-22,Newcastle,QPR,1,0,H,2012-12-22,1,0,0,0,1,0,3,0,3
2831,2012-12-22,Southampton,Sunderland,0,1,A,2012-12-22,0,1,1,1,-1,0,0,3,-3
2832,2012-12-22,Tottenham,Stoke,0,0,D,2012-12-22,1,0,0,0,1,0,4,1,3
2833,2012-12-22,West Brom,Norwich,2,1,H,2012-12-22,2,1,1,1,1,0,4,0,4
2834,2012-12-22,West Ham,Everton,1,2,A,2012-12-22,1,2,2,2,-1,0,0,3,-3
2835,2012-12-22,Wigan,Arsenal,0,1,A,2012-12-22,0,6,1,1,-1,5,0,6,-6
2836,2012-12-23,Chelsea,Aston Villa,8,0,H,2012-12-29,9,0,0,0,9,0,3,0,3
2837,2012-12-23,Swansea,Man United,1,1,D,2012-12-29,3,7,2,2,1,5,1,1,0
2838,2012-12-26,Aston Villa,Tottenham,0,4,A,2012-12-29,0,6,15,15,-15,-9,0,6,-6
2839,2012-12-26,Everton,Wigan,2,1,H,2012-12-29,2,4,1,1,1,3,3,3,0
2840,2012-12-26,Fulham,Southampton,1,1,D,2012-12-29,2,4,3,3,-1,1,1,2,-1
2841,2012-12-26,Man United,Newcastle,4,3,H,2012-12-29,7,6,4,4,3,2,6,0,6
2842,2012-12-26,Norwich,Chelsea,0,1,A,2012-12-29,3,9,5,5,-2,4,0,3,-3
2843,2012-12-26,QPR,West Brom,1,2,A,2012-12-29,1,2,2,2,-1,0,0,3,-3
2844,2012-12-26,Reading,Swansea,0,0,D,2012-12-29,1,3,0,0,1,3,4,4,0
2845,2012-12-26,Stoke,Liverpool,3,1,H,2012-12-29,6,1,4,4,2,-3,4,0,4
2846,2012-12-26,Sunderland,Man City,1,0,H,2012-12-29,2,4,2,2,0,2,3,3,0
2847,2012-12-29,Arsenal,Newcastle,7,3,H,2012-12-29,7,6,3,3,4,3,3,0,3
2848,2012-12-29,Aston Villa,Wigan,0,3,A,2012-12-29,0,4,15,15,-15,-11,0,3,-3
2849,2012-12-29,Fulham,Swansea,1,2,A,2012-12-29,2,3,3,3,-1,0,1,4,-3
2850,2012-12-29,Man United,West Brom,2,0,H,2012-12-29,7,2,4,4,3,-2,6,3,3
2851,2012-12-29,Norwich,Man City,3,4,A,2012-12-29,3,4,5,5,-2,-1,0,3,-3
2852,2012-12-29,Reading,West Ham,1,0,H,2012-12-29,1,0,0,0,1,0,4,0,4
2853,2012-12-29,Stoke,Southampton,3,3,D,2012-12-29,6,4,4,4,2,0,4,2,2
2854,2012-12-29,Sunderland,Tottenham,1,2,A,2012-12-29,2,6,2,2,0,4,3,6,-3
2855,2012-12-30,Everton,Chelsea,1,2,A,2013-01-05,3,2,3,3,0,-1,0,3,-3
2856,2012-12-30,QPR,Liverpool,0,3,A,2013-01-05,1,6,3,3,-2,3,0,3,-3
2857,2013-01-01,Man City,Stoke,3,0,H,2013-01-05,3,0,0,0,3,0,3,0,3
2858,2013-01-01,Southampton,Arsenal,1,1,D,2013-01-05,1,1,1,1,0,0,1,1,0
2859,2013-01-01,Swansea,Aston Villa,2,2,D,2013-01-05,2,2,2,2,0,0,1,1,0
2860,2013-01-01,Tottenham,Reading,3,1,H,2013-01-05,3,1,1,1,2,0,3,0,3
2861,2013-01-01,West Brom,Fulham,1,2,A,2013-01-05,1,2,2,2,-1,0,0,3,-3
2862,2013-01-01,West Ham,Norwich,2,1,H,2013-01-05,2,1,1,1,1,0,3,0,3
2863,2013-01-01,Wigan,Man United,0,4,A,2013-01-05,0,4,4,4,-4,0,0,3,-3
2864,2013-01-02,Chelsea,QPR,0,1,A,2013-01-05,2,1,2,2,0,-1,0,3,-3
2865,2013-01-02,Liverpool,Sunderland,3,0,H,2013-01-05,6,0,0,0,6,0,3,0,3
2866,2013-01-02,Newcastle,Everton,1,2,A,2013-01-05,1,3,2,2,-1,1,0,3,-3
2867,2013-01-12,Aston Villa,Southampton,0,1,A,2013-01-12,0,1,1,1,-1,0,0,3,-3
2868,2013-01-12,Everton,Swansea,0,0,D,2013-01-12,0,0,0,0,0,0,1,1,0
2869,2013-01-12,Fulham,Wigan,1,1,D,2013-01-12,1,1,1,1,0,0,1,1,0
2870,2013-01-12,Norwich,Newcastle,0,0,D,2013-01-12,0,0,0,0,0,0,1,1,0
2871,2013-01-12,QPR,Tottenham,0,0,D,2013-01-12,0,0,0,0,0,0,1,1,0
2872,2013-01-12,Reading,West Brom,3,2,H,2013-01-12,3,2,2,2,1,0,3,0,3
2873,2013-01-12,Stoke,Chelsea,0,4,A,2013-01-12,0,4,4,4,-4,0,0,3,-3
2874,2013-01-12,Sunderland,West Ham,3,0,H,2013-01-12,3,0,0,0,3,0,3,0,3
2875,2013-01-13,Arsenal,Man City,0,2,A,2013-01-19,0,4,2,2,-2,2,0,3,-3
2876,2013-01-13,Man United,Liverpool,2,1,H,2013-01-19,2,6,1,1,1,5,3,0,3
2877,2013-01-16,Chelsea,Southampton,2,2,D,2013-01-19,2,2,2,2,0,0,1,1,0
2878,2013-01-19,Liverpool,Norwich,5,0,H,2013-01-19,6,0,2,2,4,-2,3,0,3
2879,2013-01-19,Man City,Fulham,2,0,H,2013-01-19,4,0,0,0,4,0,3,0,3
2880,2013-01-19,Newcastle,Reading,1,2,A,2013-01-19,1,2,2,2,-1,0,0,3,-3
2881,2013-01-19,Swansea,Stoke,3,1,H,2013-01-19,3,1,1,1,2,0,3,0,3
2882,2013-01-19,West Brom,Aston Villa,2,2,D,2013-01-19,2,2,2,2,0,0,1,1,0
2883,2013-01-19,West Ham,QPR,1,1,D,2013-01-19,1,1,1,1,0,0,1,1,0
2884,2013-01-19,Wigan,Sunderland,2,3,A,2013-01-19,2,3,3,3,-1,0,0,3,-3
2885,2013-01-20,Chelsea,Arsenal,2,1,H,2013-01-26,2,6,1,1,1,5,3,0,3
2886,2013-01-20,Tottenham,Man United,1,1,D,2013-01-26,1,1,1,1,0,0,1,1,0
2887,2013-01-21,Southampton,Everton,0,0,D,2013-01-26,0,0,0,0,0,0,1,1,0
2888,2013-01-23,Arsenal,West Ham,5,1,H,2013-01-26,6,1,3,3,3,-2,3,0,3
2889,2013-01-29,Aston Villa,Newcastle,1,2,A,2013-02-02,4,5,5,5,-1,0,0,3,-3
2890,2013-01-29,QPR,Man City,0,0,D,2013-02-02,0,0,0,0,0,0,2,1,1
2891,2013-01-29,Stoke,Wigan,2,2,D,2013-02-02,2,4,3,3,-1,1,1,1,0
2892,2013-01-29,Sunderland,Swansea,0,0,D,2013-02-02,1,0,2,2,-1,-2,1,1,0
2893,2013-01-30,Arsenal,Liverpool,2,2,D,2013-02-02,3,2,2,2,1,0,4,1,3
2894,2013-01-30,Everton,West Brom,2,1,H,2013-02-02,5,1,4,4,1,-3,4,0,4
2895,2013-01-30,Fulham,West Ham,3,1,H,2013-02-02,3,2,2,2,1,0,3,0,3
2896,2013-01-30,Man United,Southampton,2,1,H,2013-02-02,3,3,1,1,2,2,3,1,2
2897,2013-01-30,Norwich,Tottenham,1,1,D,2013-02-02,1,1,1,1,0,0,1,1,0
2898,2013-01-30,Reading,Chelsea,2,2,D,2013-02-02,4,4,3,3,1,1,4,1,3
2899,2013-02-02,Arsenal,Stoke,1,0,H,2013-02-02,3,2,2,2,1,0,4,0,4
2900,2013-02-02,Everton,Aston Villa,3,3,D,2013-02-02,5,4,4,4,1,0,4,1,3
2901,2013-02-02,Fulham,Man United,0,1,A,2013-02-02,3,3,2,2,1,1,3,3,0
2902,2013-02-02,Newcastle,Chelsea,3,2,H,2013-02-02,5,4,3,3,2,1,3,1,2
2903,2013-02-02,QPR,Norwich,0,0,D,2013-02-02,0,1,0,0,0,1,2,1,1
2904,2013-02-02,Reading,Sunderland,2,1,H,2013-02-02,4,1,3,3,1,-2,4,0,4
2905,2013-02-02,West Ham,Swansea,1,0,H,2013-02-02,2,0,3,3,-1,-3,3,1,2
2906,2013-02-02,Wigan,Southampton,2,2,D,2013-02-02,4,3,4,4,0,-1,1,1,0
2907,2013-02-03,Man City,Liverpool,2,2,D,2013-02-09,3,2,5,5,-2,-3,1,1,0
2908,2013-02-03,West Brom,Tottenham,0,1,A,2013-02-09,0,3,1,1,-1,2,0,3,-3
2909,2013-02-09,Chelsea,Wigan,4,1,H,2013-02-09,4,1,1,1,3,0,3,0,3
2910,2013-02-09,Norwich,Fulham,0,0,D,2013-02-09,0,0,0,0,0,0,1,1,0
2911,2013-02-09,Southampton,Man City,3,1,H,2013-02-09,3,3,1,1,2,2,3,0,3
2912,2013-02-09,Stoke,Reading,2,1,H,2013-02-09,2,1,1,1,1,0,3,0,3
2913,2013-02-09,Sunderland,Arsenal,0,1,A,2013-02-09,0,1,1,1,-1,0,0,3,-3
2914,2013-02-09,Swansea,QPR,4,1,H,2013-02-09,4,1,1,1,3,0,3,0,3
2915,2013-02-09,Tottenham,Newcastle,2,1,H,2013-02-09,3,1,1,1,2,0,3,0,3
2916,2013-02-10,Aston Villa,West Ham,2,1,H,2013-02-16,2,1,1,1,1,0,3,0,3
2917,2013-02-10,Man United,Everton,2,0,H,2013-02-16,2,0,0,0,2,0,3,0,3
2918,2013-02-11,Liverpool,West Brom,0,2,A,2013-02-16,0,2,2,2,-2,0,0,3,-3
2919,2013-02-17,Liverpool,Swansea,5,0,H,2013-02-23,5,0,0,0,5,0,3,0,3
2920,2013-02-23,Arsenal,Aston Villa,2,1,H,2013-02-23,2,1,1,1,1,0,3,0,3
2921,2013-02-23,Fulham,Stoke,1,0,H,2013-02-23,1,0,0,0,1,0,3,0,3
2922,2013-02-23,Norwich,Everton,2,1,H,2013-02-23,2,1,1,1,1,0,3,0,3
2923,2013-02-23,QPR,Man United,0,2,A,2013-02-23,0,2,2,2,-2,0,0,3,-3
2924,2013-02-23,Reading,Wigan,0,3,A,2013-02-23,0,3,3,3,-3,0,0,3,-3
2925,2013-02-23,West Brom,Sunderland,2,1,H,2013-02-23,2,1,1,1,1,0,3,0,3
2926,2013-02-24,Man City,Chelsea,2,0,H,2013-03-02,2,1,0,0,2,1,3,0,3
2927,2013-02-24,Newcastle,Southampton,4,2,H,2013-03-02,4,3,3,3,1,0,3,0,3
2928,2013-02-25,West Ham,Tottenham,2,3,A,2013-03-02,3,3,3,3,0,0,0,3,-3
2929,2013-03-02,Chelsea,West Brom,1,0,H,2013-03-02,1,0,2,2,-1,-2,3,0,3
2930,2013-03-02,Everton,Reading,3,1,H,2013-03-02,3,1,1,1,2,0,3,0,3
2931,2013-03-02,Man United,Norwich,4,0,H,2013-03-02,4,0,0,0,4,0,3,0,3
2932,2013-03-02,Southampton,QPR,1,2,A,2013-03-02,3,2,6,6,-3,-4,0,3,-3
2933,2013-03-02,Stoke,West Ham,0,1,A,2013-03-02,0,3,1,1,-1,2,0,3,-3
2934,2013-03-02,Sunderland,Fulham,2,2,D,2013-03-02,2,2,2,2,0,0,1,1,0
2935,2013-03-02,Swansea,Newcastle,1,0,H,2013-03-02,1,4,0,0,1,4,3,0,3
2936,2013-03-02,Wigan,Liverpool,0,4,A,2013-03-02,0,4,4,4,-4,0,0,3,-3
2937,2013-03-03,Tottenham,Arsenal,2,1,H,2013-03-09,2,1,1,1,1,0,3,0,3
2938,2013-03-04,Aston Villa,Man City,0,1,A,2013-03-09,2,1,2,2,0,-1,0,3,-3
2939,2013-03-09,Norwich,Southampton,0,0,D,2013-03-09,0,0,0,0,0,0,1,1,0
2940,2013-03-09,QPR,Sunderland,3,1,H,2013-03-09,3,1,1,1,2,0,3,0,3
2941,2013-03-09,Reading,Aston Villa,1,2,A,2013-03-09,1,2,2,2,-1,0,0,3,-3
2942,2013-03-09,West Brom,Swansea,2,1,H,2013-03-09,2,1,1,1,1,0,3,0,3
2943,2013-03-10,Liverpool,Tottenham,3,2,H,2013-03-16,4,2,5,5,-1,-3,3,0,3
2944,2013-03-10,Newcastle,Stoke,2,1,H,2013-03-16,2,1,1,1,1,0,3,0,3
2945,2013-03-16,Aston Villa,QPR,3,2,H,2013-03-16,3,2,2,2,1,0,3,0,3
2946,2013-03-16,Everton,Man City,2,0,H,2013-03-16,2,0,0,0,2,0,3,0,3
2947,2013-03-16,Man United,Reading,1,0,H,2013-03-16,1,0,0,0,1,0,3,0,3
2948,2013-03-16,Southampton,Liverpool,3,1,H,2013-03-16,3,4,1,1,2,3,3,0,3
2949,2013-03-16,Stoke,West Brom,0,0,D,2013-03-16,1,0,2,2,-1,-2,1,1,0
2950,2013-03-16,Swansea,Arsenal,0,2,A,2013-03-16,0,2,2,2,-2,0,0,3,-3
2951,2013-03-17,Chelsea,West Ham,2,0,H,2013-03-23,2,0,0,0,2,0,3,0,3
2952,2013-03-17,Sunderland,Norwich,1,1,D,2013-03-23,1,1,1,1,0,0,1,1,0
2953,2013-03-17,Tottenham,Fulham,0,1,A,2013-03-23,0,1,1,1,-1,0,0,3,-3
2954,2013-03-17,Wigan,Newcastle,2,1,H,2013-03-23,2,1,1,1,1,0,3,0,3
2955,2013-03-30,Arsenal,Reading,4,1,H,2013-03-30,4,1,1,1,3,0,3,0,3
2956,2013-03-30,Everton,Stoke,1,0,H,2013-03-30,1,0,0,0,1,0,3,0,3
2957,2013-03-30,Man City,Newcastle,4,0,H,2013-03-30,4,0,0,0,4,0,3,0,3
2958,2013-03-30,Southampton,Chelsea,2,1,H,2013-03-30,2,1,1,1,1,0,3,0,3
2959,2013-03-30,Sunderland,Man United,0,1,A,2013-03-30,0,1,1,1,-1,0,0,3,-3
2960,2013-03-30,Swansea,Tottenham,1,2,A,2013-03-30,1,2,2,2,-1,0,0,3,-3
2961,2013-03-30,West Ham,West Brom,3,1,H,2013-03-30,3,1,1,1,2,0,3,0,3
2962,2013-03-30,Wigan,Norwich,1,0,H,2013-03-30,1,0,0,0,1,0,3,0,3
2963,2013-03-31,Aston Villa,Liverpool,1,2,A,2013-04-06,4,2,3,3,1,-1,0,3,-3
2964,2013-04-01,Fulham,QPR,3,2,H,2013-04-06,3,2,2,2,1,0,3,0,3
2965,2013-04-06,Norwich,Swansea,2,2,D,2013-04-06,2,2,2,2,0,0,1,1,0
2966,2013-04-06,Reading,Southampton,0,2,A,2013-04-06,0,2,2,2,-2,0,0,3,-3
2967,2013-04-06,Stoke,Aston Villa,1,3,A,2013-04-06,1,4,3,3,-2,1,0,3,-3
2968,2013-04-06,West Brom,Arsenal,1,2,A,2013-04-06,1,2,2,2,-1,0,0,3,-3
2969,2013-04-07,Chelsea,Sunderland,2,1,H,2013-04-13,2,1,1,1,1,0,3,0,3
2970,2013-04-07,Liverpool,West Ham,0,0,D,2013-04-13,0,1,0,0,0,1,1,2,-1
2971,2013-04-07,Newcastle,Fulham,1,0,H,2013-04-13,1,1,0,0,1,1,3,1,2
2972,2013-04-07,QPR,Wigan,1,1,D,2013-04-13,1,1,3,3,-2,-2,1,1,0
2973,2013-04-07,Tottenham,Everton,2,2,D,2013-04-13,2,4,2,2,0,2,1,1,0
2974,2013-04-08,Man United,Man City,1,2,A,2013-04-13,1,2,2,2,-1,0,0,3,-3
2975,2013-04-13,Arsenal,Norwich,3,1,H,2013-04-13,3,1,1,1,2,0,3,0,3
2976,2013-04-13,Aston Villa,Fulham,1,1,D,2013-04-13,1,1,1,1,0,0,1,1,0
2977,2013-04-13,Everton,QPR,2,0,H,2013-04-13,4,1,2,2,2,-1,3,0,3
2978,2013-04-13,Reading,Liverpool,0,0,D,2013-04-13,0,0,0,0,0,0,1,1,0
2979,2013-04-13,Southampton,West Ham,1,1,D,2013-04-13,1,1,1,1,0,0,1,2,-1
2980,2013-04-14,Newcastle,Sunderland,0,3,A,2013-04-20,1,4,4,4,-3,0,0,3,-3
2981,2013-04-14,Stoke,Man United,0,2,A,2013-04-20,2,4,2,2,0,2,0,4,-4
2982,2013-04-16,Arsenal,Everton,0,0,D,2013-04-20,1,0,0,0,1,0,1,1,0
2983,2013-04-17,Fulham,Chelsea,0,3,A,2013-04-20,0,3,4,4,-4,-1,0,3,-3
2984,2013-04-17,Man City,Wigan,1,0,H,2013-04-20,1,0,0,0,1,0,3,0,3
2985,2013-04-17,West Ham,Man United,2,2,D,2013-04-20,4,4,2,2,2,2,4,4,0
2986,2013-04-20,Fulham,Arsenal,0,1,A,2013-04-20,0,1,4,4,-4,-3,0,3,-3
2987,2013-04-20,Norwich,Reading,2,1,H,2013-04-20,2,1,1,1,1,0,3,0,3
2988,2013-04-20,QPR,Stoke,0,2,A,2013-04-20,0,2,2,2,-2,0,0,3,-3
2989,2013-04-20,Sunderland,Everton,1,0,H,2013-04-20,4,0,0,0,4,0,3,1,2
2990,2013-04-20,Swansea,Southampton,0,0,D,2013-04-20,0,0,0,0,0,0,1,1,0
2991,2013-04-20,West Brom,Newcastle,1,1,D,2013-04-20,1,1,1,1,0,0,1,1,0
2992,2013-04-20,West Ham,Wigan,2,0,H,2013-04-20,4,0,2,2,2,-2,4,0,4
2993,2013-04-21,Liverpool,Chelsea,2,2,D,2013-04-27,8,2,2,2,6,0,1,1,0
2994,2013-04-21,Tottenham,Man City,3,1,H,2013-04-27,5,3,3,3,2,0,3,0,3
2995,2013-04-22,Man United,Aston Villa,3,0,H,2013-04-27,3,0,0,0,3,0,3,0,3
2996,2013-04-27,Everton,Fulham,1,0,H,2013-04-27,1,0,0,0,1,0,3,0,3
2997,2013-04-27,Man City,West Ham,2,1,H,2013-04-27,3,1,4,4,-1,-3,3,0,3
2998,2013-04-27,Newcastle,Liverpool,0,6,A,2013-04-27,0,8,6,6,-6,2,0,3,-3
2999,2013-04-27,Southampton,West Brom,0,3,A,2013-04-27,0,3,3,3,-3,0,0,3,-3
3000,2013-04-27,Stoke,Norwich,1,0,H,2013-04-27,1,0,0,0,1,0,3,0,3
3001,2013-04-27,Wigan,Tottenham,2,2,D,2013-04-27,2,5,2,2,0,3,1,1,0
3002,2013-04-28,Arsenal,Man United,1,1,D,2013-05-04,2,1,1,1,1,0,1,1,0
3003,2013-04-28,Chelsea,Swansea,2,0,H,2013-05-04,2,0,0,0,2,0,3,0,3
3004,2013-04-28,Reading,QPR,0,0,D,2013-05-04,4,0,2,2,2,-2,1,1,0
3005,2013-04-29,Aston Villa,Sunderland,6,1,H,2013-05-04,8,1,2,2,6,-1,3,0,3
3006,2013-05-04,Fulham,Reading,2,4,A,2013-05-04,2,4,4,4,-2,0,0,3,-3
3007,2013-05-04,Norwich,Aston Villa,1,2,A,2013-05-04,1,8,2,2,-1,6,0,3,-3
3008,2013-05-04,QPR,Arsenal,0,1,A,2013-05-04,0,2,1,1,-1,1,0,3,-3
3009,2013-05-04,Swansea,Man City,0,0,D,2013-05-04,0,0,2,2,-2,-2,1,1,0
3010,2013-05-04,Tottenham,Southampton,1,0,H,2013-05-04,1,0,0,0,1,0,3,0,3
3011,2013-05-04,West Brom,Wigan,2,3,A,2013-05-04,2,3,3,3,-1,0,0,3,-3
3012,2013-05-04,West Ham,Newcastle,0,0,D,2013-05-04,0,0,0,0,0,0,1,1,0
3013,2013-05-05,Liverpool,Everton,0,0,D,2013-05-11,0,0,0,0,0,0,1,1,0
3014,2013-05-05,Man United,Chelsea,0,1,A,2013-05-11,0,5,1,1,-1,4,0,6,-6
3015,2013-05-06,Sunderland,Stoke,1,1,D,2013-05-11,1,1,1,1,0,0,1,1,0
3016,2013-05-07,Man City,West Brom,1,0,H,2013-05-11,1,0,0,0,1,0,3,0,3
3017,2013-05-07,Wigan,Swansea,2,3,A,2013-05-11,2,3,3,3,-1,0,0,3,-3
3018,2013-05-08,Chelsea,Tottenham,2,2,D,2013-05-11,5,2,3,3,2,-1,1,1,0
3019,2013-05-11,Aston Villa,Chelsea,1,2,A,2013-05-11,1,5,2,2,-1,3,0,6,-6
3020,2013-05-12,Everton,West Ham,2,0,H,2013-05-18,2,0,0,0,2,0,3,0,3
3021,2013-05-12,Fulham,Liverpool,1,3,A,2013-05-18,1,3,3,3,-2,0,0,3,-3
3022,2013-05-12,Man United,Swansea,2,1,H,2013-05-18,2,1,1,1,1,0,3,0,3
3023,2013-05-12,Norwich,West Brom,4,0,H,2013-05-18,4,0,0,0,4,0,3,0,3
3024,2013-05-12,QPR,Newcastle,1,2,A,2013-05-18,1,2,2,2,-1,0,0,3,-3
3025,2013-05-12,Stoke,Tottenham,1,2,A,2013-05-18,1,2,2,2,-1,0,0,3,-3
3026,2013-05-12,Sunderland,Southampton,1,1,D,2013-05-18,1,1,1,1,0,0,1,1,0
3027,2013-05-14,Arsenal,Wigan,4,1,H,2013-05-18,4,1,1,1,3,0,3,0,3
3028,2013-05-14,Reading,Man City,0,2,A,2013-05-18,0,2,2,2,-2,0,0,3,-3
3029,2013-05-19,Chelsea,Everton,2,1,H,2013-05-25,2,1,1,1,1,0,3,0,3
3030,2013-05-19,Liverpool,QPR,1,0,H,2013-05-25,1,0,0,0,1,0,3,0,3
3031,2013-05-19,Man City,Norwich,2,3,A,2013-05-25,2,3,3,3,-1,0,0,3,-3
3032,2013-05-19,Newcastle,Arsenal,0,1,A,2013-05-25,0,1,1,1,-1,0,0,3,-3
3033,2013-05-19,Southampton,Stoke,1,1,D,2013-05-25,1,1,1,1,0,0,1,1,0
3034,2013-05-19,Swansea,Fulham,0,3,A,2013-05-25,0,3,3,3,-3,0,0,3,-3
3035,2013-05-19,Tottenham,Sunderland,1,0,H,2013-05-25,1,0,0,0,1,0,3,0,3
3036,2013-05-19,West Brom,Man United,5,5,D,2013-05-25,5,5,5,5,0,0,1,1,0
3037,2013-05-19,West Ham,Reading,4,2,H,2013-05-25,4,2,2,2,2,0,3,0,3
3038,2013-05-19,Wigan,Aston Villa,2,2,D,2013-05-25,2,2,2,2,0,0,1,1,0
3039,2013-08-17,Arsenal,Aston Villa,1,3,A,2013-08-17,1,3,3,3,-2,0,0,3,-3
3040,2013-08-17,Liverpool,Stoke,1,0,H,2013-08-17,1,0,0,0,1,0,3,0,3
3041,2013-08-17,Norwich,Everton,2,2,D,2013-08-17,2,2,2,2,0,0,1,1,0
3042,2013-08-17,Sunderland,Fulham,0,1,A,2013-08-17,0,1,1,1,-1,0,0,3,-3
3043,2013-08-17,Swansea,Man United,1,4,A,2013-08-17,1,4,4,4,-3,0,0,3,-3
3044,2013-08-17,West Brom,Southampton,0,1,A,2013-08-17,0,1,1,1,-1,0,0,3,-3
3045,2013-08-17,West Ham,Cardiff,2,0,H,2013-08-17,2,0,0,0,2,0,3,0,3
3046,2013-08-18,Chelsea,Hull,2,0,H,2013-08-24,4,1,1,1,3,0,6,0,6
3047,2013-08-18,Crystal Palace,Tottenham,0,1,A,2013-08-24,1,1,3,3,-2,-2,0,3,-3
3048,2013-08-19,Man City,Newcastle,4,0,H,2013-08-24,4,0,0,0,4,0,3,0,3
3049,2013-08-21,Chelsea,Aston Villa,2,1,H,2013-08-24,4,1,1,1,3,0,6,0,6
3050,2013-08-24,Aston Villa,Liverpool,0,1,A,2013-08-24,1,1,3,3,-2,-2,0,3,-3
3051,2013-08-24,Everton,West Brom,0,0,D,2013-08-24,0,0,0,0,0,0,1,1,0
3052,2013-08-24,Fulham,Arsenal,1,3,A,2013-08-24,1,3,3,3,-2,0,0,3,-3
3053,2013-08-24,Hull,Norwich,1,0,H,2013-08-24,1,0,2,2,-1,-2,3,0,3
3054,2013-08-24,Newcastle,West Ham,0,0,D,2013-08-24,0,0,4,4,-4,-4,1,1,0
3055,2013-08-24,Southampton,Sunderland,1,1,D,2013-08-24,1,1,1,1,0,0,1,1,0
3056,2013-08-24,Stoke,Crystal Palace,2,1,H,2013-08-24,2,1,1,1,1,0,3,0,3
3057,2013-08-25,Cardiff,Man City,3,2,H,2013-08-31,3,4,2,2,1,2,4,0,4
3058,2013-08-25,Tottenham,Swansea,1,0,H,2013-08-31,1,0,0,0,1,0,3,0,3
3059,2013-08-26,Man United,Chelsea,0,0,D,2013-08-31,0,0,0,0,0,0,1,1,0
3060,2013-08-31,Cardiff,Everton,0,0,D,2013-08-31,3,0,2,2,1,-2,4,1,3
3061,2013-08-31,Crystal Palace,Sunderland,3,1,H,2013-08-31,3,1,1,1,2,0,3,0,3
3062,2013-08-31,Man City,Hull,2,0,H,2013-08-31,4,0,3,3,1,-3,3,0,3
3063,2013-08-31,Newcastle,Fulham,1,0,H,2013-08-31,1,0,0,0,1,0,3,0,3
3064,2013-08-31,Norwich,Southampton,1,0,H,2013-08-31,1,0,0,0,1,0,3,0,3
3065,2013-08-31,West Ham,Stoke,0,1,A,2013-08-31,0,1,1,1,-1,0,0,3,-3
3066,2013-09-01,Arsenal,Tottenham,1,0,H,2013-09-07,1,0,0,0,1,0,3,0,3
3067,2013-09-01,Liverpool,Man United,1,0,H,2013-09-07,1,0,0,0,1,0,3,0,3
3068,2013-09-01,West Brom,Swansea,0,2,A,2013-09-07,0,2,2,2,-2,0,0,3,-3
3069,2013-09-14,Aston Villa,Newcastle,1,2,A,2013-09-14,1,2,2,2,-1,0,0,3,-3
3070,2013-09-14,Everton,Chelsea,1,0,H,2013-09-14,1,0,0,0,1,0,3,0,3
3071,2013-09-14,Fulham,West Brom,1,1,D,2013-09-14,1,1,1,1,0,0,1,1,0
3072,2013-09-14,Hull,Cardiff,1,1,D,2013-09-14,1,1,1,1,0,0,1,1,0
3073,2013-09-14,Man United,Crystal Palace,2,0,H,2013-09-14,2,0,0,0,2,0,3,0,3
3074,2013-09-14,Stoke,Man City,0,0,D,2013-09-14,0,0,0,0,0,0,1,1,0
3075,2013-09-14,Sunderland,Arsenal,1,3,A,2013-09-14,1,3,3,3,-2,0,0,3,-3
3076,2013-09-14,Tottenham,Norwich,2,0,H,2013-09-14,2,0,0,0,2,0,3,0,3
3077,2013-09-15,Southampton,West Ham,0,0,D,2013-09-21,1,2,0,0,1,2,1,1,0
3078,2013-09-16,Swansea,Liverpool,2,2,D,2013-09-21,2,2,2,2,0,0,1,1,0
3079,2013-09-21,Chelsea,Fulham,2,0,H,2013-09-21,2,0,0,0,2,0,3,0,3
3080,2013-09-21,Liverpool,Southampton,0,1,A,2013-09-21,2,1,3,3,-1,-2,0,3,-3
3081,2013-09-21,Newcastle,Hull,2,3,A,2013-09-21,2,3,3,3,-1,0,0,3,-3
3082,2013-09-21,Norwich,Aston Villa,0,1,A,2013-09-21,0,1,1,1,-1,0,0,3,-3
3083,2013-09-21,West Brom,Sunderland,3,0,H,2013-09-21,3,0,0,0,3,0,3,0,3
3084,2013-09-21,West Ham,Everton,2,3,A,2013-09-21,2,3,3,3,-1,0,0,3,-3
3085,2013-09-22,Arsenal,Stoke,3,1,H,2013-09-28,5,1,2,2,3,-1,3,0,3
3086,2013-09-22,Cardiff,Tottenham,0,1,A,2013-09-28,2,2,2,2,0,0,0,3,-3
3087,2013-09-22,Crystal Palace,Swansea,0,2,A,2013-09-28,0,3,4,4,-4,-1,0,3,-3
3088,2013-09-22,Man City,Man United,4,1,H,2013-09-28,6,2,4,4,2,-2,3,0,3
3089,2013-09-28,Aston Villa,Man City,3,2,H,2013-09-28,3,6,2,2,1,4,3,0,3
3090,2013-09-28,Fulham,Cardiff,1,2,A,2013-09-28,1,2,2,2,-1,0,0,3,-3
3091,2013-09-28,Hull,West Ham,1,0,H,2013-09-28,1,0,0,0,1,0,3,0,3
3092,2013-09-28,Man United,West Brom,1,2,A,2013-09-28,2,2,6,6,-4,-4,0,3,-3
3093,2013-09-28,Southampton,Crystal Palace,2,0,H,2013-09-28,2,0,0,0,2,0,3,0,3
3094,2013-09-28,Swansea,Arsenal,1,2,A,2013-09-28,3,5,2,2,1,3,0,3,-3
3095,2013-09-28,Tottenham,Chelsea,1,1,D,2013-09-28,2,1,1,1,1,0,1,1,0
3096,2013-09-29,Stoke,Norwich,0,1,A,2013-10-05,0,1,2,2,-2,-1,0,3,-3
3097,2013-09-29,Sunderland,Liverpool,1,3,A,2013-10-05,2,6,5,5,-3,1,0,3,-3
3098,2013-09-30,Everton,Newcastle,3,2,H,2013-10-05,4,4,5,5,-1,-1,3,3,0
3099,2013-10-05,Cardiff,Newcastle,1,2,A,2013-10-05,1,4,2,2,-1,2,0,3,-3
3100,2013-10-05,Fulham,Stoke,1,0,H,2013-10-05,1,0,0,0,1,0,3,0,3
3101,2013-10-05,Hull,Aston Villa,0,0,D,2013-10-05,0,0,0,0,0,0,1,1,0
3102,2013-10-05,Liverpool,Crystal Palace,3,1,H,2013-10-05,6,1,2,2,4,-1,3,0,3
3103,2013-10-05,Man City,Everton,3,1,H,2013-10-05,3,4,1,1,2,3,3,0,3
3104,2013-10-05,Sunderland,Man United,1,2,A,2013-10-05,2,2,5,5,-3,-3,0,3,-3
3105,2013-10-06,Norwich,Chelsea,1,3,A,2013-10-12,1,3,3,3,-2,0,0,3,-3
3106,2013-10-06,Southampton,Swansea,2,0,H,2013-10-12,2,0,0,0,2,0,3,0,3
3107,2013-10-06,Tottenham,West Ham,0,3,A,2013-10-12,0,3,3,3,-3,0,0,3,-3
3108,2013-10-06,West Brom,Arsenal,1,1,D,2013-10-12,1,1,1,1,0,0,1,1,0
3109,2013-10-19,Arsenal,Norwich,4,1,H,2013-10-19,4,1,1,1,3,0,3,0,3
3110,2013-10-19,Chelsea,Cardiff,4,1,H,2013-10-19,4,1,1,1,3,0,3,0,3
3111,2013-10-19,Everton,Hull,2,1,H,2013-10-19,2,1,1,1,1,0,3,0,3
3112,2013-10-19,Man United,Southampton,1,1,D,2013-10-19,1,1,1,1,0,0,1,1,0
3113,2013-10-19,Newcastle,Liverpool,2,2,D,2013-10-19,2,2,2,2,0,0,1,1,0
3114,2013-10-19,Stoke,West Brom,0,0,D,2013-10-19,0,0,0,0,0,0,1,1,0
3115,2013-10-19,Swansea,Sunderland,4,0,H,2013-10-19,4,0,0,0,4,0,3,0,3
3116,2013-10-19,West Ham,Man City,1,3,A,2013-10-19,1,3,3,3,-2,0,0,3,-3
3117,2013-10-20,Aston Villa,Tottenham,0,2,A,2013-10-26,0,2,4,4,-4,-2,0,3,-3
3118,2013-10-21,Crystal Palace,Fulham,1,4,A,2013-10-26,1,4,6,6,-5,-2,0,3,-3
3119,2013-10-26,Aston Villa,Everton,0,2,A,2013-10-26,0,2,4,4,-4,-2,0,3,-3
3120,2013-10-26,Crystal Palace,Arsenal,0,2,A,2013-10-26,1,2,6,6,-5,-4,0,3,-3
3121,2013-10-26,Liverpool,West Brom,4,1,H,2013-10-26,4,1,1,1,3,0,3,0,3
3122,2013-10-26,Man United,Stoke,3,2,H,2013-10-26,3,2,2,2,1,0,3,0,3
3123,2013-10-26,Norwich,Cardiff,0,0,D,2013-10-26,0,0,0,0,0,0,1,1,0
3124,2013-10-26,Southampton,Fulham,2,0,H,2013-10-26,2,4,0,0,2,4,3,3,0
3125,2013-10-27,Chelsea,Man City,2,1,H,2013-11-02,2,8,3,3,-1,5,3,0,3
3126,2013-10-27,Sunderland,Newcastle,2,1,H,2013-11-02,2,3,2,2,0,1,3,0,3
3127,2013-10-27,Swansea,West Ham,0,0,D,2013-11-02,0,0,0,0,0,0,1,1,0
3128,2013-10-27,Tottenham,Hull,1,0,H,2013-11-02,1,1,0,0,1,1,3,0,3
3129,2013-11-02,Arsenal,Liverpool,2,0,H,2013-11-02,2,0,0,0,2,0,3,0,3
3130,2013-11-02,Fulham,Man United,1,3,A,2013-11-02,1,3,3,3,-2,0,0,3,-3
3131,2013-11-02,Hull,Sunderland,1,0,H,2013-11-02,1,2,1,1,0,1,3,0,3
3132,2013-11-02,Man City,Norwich,7,0,H,2013-11-02,8,0,2,2,6,-2,3,0,3
3133,2013-11-02,Newcastle,Chelsea,2,0,H,2013-11-02,3,2,2,2,1,0,3,0,3
3134,2013-11-02,Stoke,Southampton,1,1,D,2013-11-02,1,1,1,1,0,0,1,1,0
3135,2013-11-02,West Brom,Crystal Palace,2,0,H,2013-11-02,2,0,0,0,2,0,3,0,3
3136,2013-11-02,West Ham,Aston Villa,0,0,D,2013-11-02,0,0,0,0,0,0,1,1,0
3137,2013-11-03,Cardiff,Swansea,1,0,H,2013-11-09,1,0,2,2,-1,-2,3,0,3
3138,2013-11-03,Everton,Tottenham,0,0,D,2013-11-09,0,0,0,0,0,0,1,1,0
3139,2013-11-09,Aston Villa,Cardiff,2,0,H,2013-11-09,2,1,0,0,2,1,3,0,3
3140,2013-11-09,Chelsea,West Brom,2,2,D,2013-11-09,2,2,2,2,0,0,1,1,0
3141,2013-11-09,Crystal Palace,Everton,0,0,D,2013-11-09,0,0,0,0,0,0,1,1,0
3142,2013-11-09,Liverpool,Fulham,4,0,H,2013-11-09,4,0,0,0,4,0,3,0,3
3143,2013-11-09,Norwich,West Ham,3,1,H,2013-11-09,3,1,1,1,2,0,3,0,3
3144,2013-11-09,Southampton,Hull,4,1,H,2013-11-09,4,1,1,1,3,0,3,0,3
3145,2013-11-10,Man United,Arsenal,1,0,H,2013-11-16,1,0,0,0,1,0,3,0,3
3146,2013-11-10,Sunderland,Man City,1,0,H,2013-11-16,1,0,0,0,1,0,3,0,3
3147,2013-11-10,Swansea,Stoke,3,3,D,2013-11-16,3,3,3,3,0,0,1,1,0
3148,2013-11-10,Tottenham,Newcastle,0,1,A,2013-11-16,0,1,1,1,-1,0,0,3,-3
3149,2013-11-23,Arsenal,Southampton,2,0,H,2013-11-23,2,0,0,0,2,0,3,0,3
3150,2013-11-23,Everton,Liverpool,3,3,D,2013-11-23,3,3,3,3,0,0,1,1,0
3151,2013-11-23,Fulham,Swansea,1,2,A,2013-11-23,1,2,2,2,-1,0,0,3,-3
3152,2013-11-23,Hull,Crystal Palace,0,1,A,2013-11-23,0,1,1,1,-1,0,0,3,-3
3153,2013-11-23,Newcastle,Norwich,2,1,H,2013-11-23,2,1,1,1,1,0,3,0,3
3154,2013-11-23,Stoke,Sunderland,2,0,H,2013-11-23,2,0,0,0,2,0,3,0,3
3155,2013-11-23,West Ham,Chelsea,0,3,A,2013-11-23,0,3,3,3,-3,0,0,3,-3
3156,2013-11-24,Cardiff,Man United,2,2,D,2013-11-30,2,2,5,5,-3,-3,1,1,0
3157,2013-11-24,Man City,Tottenham,6,0,H,2013-11-30,6,0,0,0,6,0,3,0,3
3158,2013-11-25,West Brom,Aston Villa,2,2,D,2013-11-30,3,2,4,4,-1,-2,1,1,0
3159,2013-11-30,Aston Villa,Sunderland,0,0,D,2013-11-30,2,0,2,2,0,-2,1,1,0
3160,2013-11-30,Cardiff,Arsenal,0,3,A,2013-11-30,2,3,5,5,-3,-2,1,3,-2
3161,2013-11-30,Everton,Stoke,4,0,H,2013-11-30,4,0,0,0,4,0,3,0,3
3162,2013-11-30,Newcastle,West Brom,2,1,H,2013-11-30,2,3,1,1,1,2,3,0,3
3163,2013-11-30,Norwich,Crystal Palace,1,0,H,2013-11-30,1,0,0,0,1,0,3,0,3
3164,2013-11-30,West Ham,Fulham,3,0,H,2013-11-30,3,0,0,0,3,0,3,0,3
3165,2013-12-01,Chelsea,Southampton,3,1,H,2013-12-07,9,4,7,7,2,-3,3,0,3
3166,2013-12-01,Hull,Liverpool,3,1,H,2013-12-07,3,10,3,3,0,7,3,0,3
3167,2013-12-01,Man City,Swansea,3,0,H,2013-12-07,7,3,3,3,4,0,3,0,3
3168,2013-12-01,Tottenham,Man United,2,2,D,2013-12-07,6,2,4,4,2,-2,1,1,0
3169,2013-12-03,Crystal Palace,West Ham,1,0,H,2013-12-07,3,1,0,0,3,1,6,0,6
3170,2013-12-04,Arsenal,Hull,2,0,H,2013-12-07,2,3,0,0,2,3,3,0,3
3171,2013-12-04,Fulham,Tottenham,1,2,A,2013-12-07,1,6,2,2,-1,4,0,6,-6
3172,2013-12-04,Liverpool,Norwich,5,1,H,2013-12-07,10,3,5,5,5,-2,6,3,3
3173,2013-12-04,Man United,Everton,0,1,A,2013-12-07,2,1,4,4,-2,-3,0,3,-3
3174,2013-12-04,Southampton,Aston Villa,2,3,A,2013-12-07,4,3,7,7,-3,-4,1,3,-2
3175,2013-12-04,Stoke,Cardiff,0,0,D,2013-12-07,3,0,2,2,1,-2,4,1,3
3176,2013-12-04,Sunderland,Chelsea,3,4,A,2013-12-07,4,9,6,6,-2,3,0,3,-3
3177,2013-12-04,Swansea,Newcastle,3,0,H,2013-12-07,3,1,3,3,0,-2,3,3,0
3178,2013-12-04,West Brom,Man City,2,3,A,2013-12-07,2,7,5,5,-3,2,0,4,-4
3179,2013-12-07,Crystal Palace,Cardiff,2,0,H,2013-12-07,3,0,0,0,3,0,6,1,5
3180,2013-12-07,Liverpool,West Ham,4,1,H,2013-12-07,10,1,5,5,5,-4,6,0,6
3181,2013-12-07,Man United,Newcastle,0,1,A,2013-12-07,2,1,4,4,-2,-3,0,3,-3
3182,2013-12-07,Southampton,Man City,1,1,D,2013-12-07,4,7,7,7,-3,0,1,4,-3
3183,2013-12-07,Stoke,Chelsea,3,2,H,2013-12-07,3,9,2,2,1,7,4,3,1
3184,2013-12-07,Sunderland,Tottenham,1,2,A,2013-12-07,4,6,6,6,-2,0,0,6,-6
3185,2013-12-07,West Brom,Norwich,0,2,A,2013-12-07,2,3,5,5,-3,-2,0,3,-3
3186,2013-12-08,Arsenal,Everton,1,1,D,2013-12-14,4,5,7,7,-3,-2,1,1,0
3187,2013-12-08,Fulham,Aston Villa,2,0,H,2013-12-14,3,0,4,4,-1,-4,3,0,3
3188,2013-12-09,Swansea,Hull,1,1,D,2013-12-14,1,1,1,1,0,0,1,1,0
3189,2013-12-14,Cardiff,West Brom,1,0,H,2013-12-14,1,0,0,0,1,0,3,0,3
3190,2013-12-14,Chelsea,Crystal Palace,2,1,H,2013-12-14,2,1,1,1,1,0,3,0,3
3191,2013-12-14,Everton,Fulham,4,1,H,2013-12-14,5,3,2,2,3,1,3,0,3
3192,2013-12-14,Hull,Stoke,0,0,D,2013-12-14,1,0,1,1,0,-1,1,1,0
3193,2013-12-14,Man City,Arsenal,6,3,H,2013-12-14,6,4,3,3,3,1,3,0,3
3194,2013-12-14,Newcastle,Southampton,1,1,D,2013-12-14,1,1,1,1,0,0,1,1,0
3195,2013-12-14,West Ham,Sunderland,0,0,D,2013-12-14,0,0,0,0,0,0,1,1,0
3196,2013-12-15,Aston Villa,Man United,0,3,A,2013-12-21,1,6,5,5,-4,1,0,3,-3
3197,2013-12-15,Norwich,Swansea,1,1,D,2013-12-21,1,1,1,1,0,0,1,1,0
3198,2013-12-15,Tottenham,Liverpool,0,5,A,2013-12-21,0,8,5,5,-5,3,0,3,-3
3199,2013-12-21,Crystal Palace,Newcastle,0,3,A,2013-12-21,0,3,3,3,-3,0,0,3,-3
3200,2013-12-21,Fulham,Man City,2,4,A,2013-12-21,2,4,4,4,-2,0,0,3,-3
3201,2013-12-21,Liverpool,Cardiff,3,1,H,2013-12-21,8,1,1,1,7,0,3,0,3
3202,2013-12-21,Man United,West Ham,3,1,H,2013-12-21,6,1,1,1,5,0,3,0,3
3203,2013-12-21,Stoke,Aston Villa,2,1,H,2013-12-21,2,1,1,1,1,0,3,0,3
3204,2013-12-21,Sunderland,Norwich,0,0,D,2013-12-21,0,1,0,0,0,1,1,1,0
3205,2013-12-21,West Brom,Hull,1,1,D,2013-12-21,1,1,1,1,0,0,1,1,0
3206,2013-12-22,Southampton,Tottenham,2,3,A,2013-12-28,5,4,3,3,2,1,0,3,-3
3207,2013-12-22,Swansea,Everton,1,2,A,2013-12-28,2,2,4,4,-2,-2,0,3,-3
3208,2013-12-23,Arsenal,Chelsea,0,0,D,2013-12-28,3,1,1,1,2,0,1,1,0
3209,2013-12-26,Aston Villa,Crystal Palace,0,1,A,2013-12-28,1,1,2,2,-1,-1,1,3,-2
3210,2013-12-26,Cardiff,Southampton,0,3,A,2013-12-28,2,5,5,5,-3,0,1,3,-2
3211,2013-12-26,Chelsea,Swansea,1,0,H,2013-12-28,1,2,0,0,1,2,3,1,2
3212,2013-12-26,Everton,Sunderland,0,1,A,2013-12-28,2,3,2,2,0,1,0,4,-4
3213,2013-12-26,Hull,Man United,2,3,A,2013-12-28,8,4,3,3,5,1,3,6,-3
3214,2013-12-26,Man City,Liverpool,2,1,H,2013-12-28,3,1,1,1,2,0,6,0,6
3215,2013-12-26,Newcastle,Stoke,5,1,H,2013-12-28,5,1,1,1,4,0,3,0,3
3216,2013-12-26,Norwich,Fulham,1,2,A,2013-12-28,1,2,3,3,-2,-1,0,3,-3
3217,2013-12-26,Tottenham,West Brom,1,1,D,2013-12-28,4,4,3,3,1,1,1,2,-1
3218,2013-12-26,West Ham,Arsenal,1,3,A,2013-12-28,4,3,6,6,-2,-3,1,3,-2
3219,2013-12-28,Aston Villa,Swansea,1,1,D,2013-12-28,1,2,2,2,-1,0,1,1,0
3220,2013-12-28,Cardiff,Sunderland,2,2,D,2013-12-28,2,3,5,5,-3,-2,1,4,-3
3221,2013-12-28,Hull,Fulham,6,0,H,2013-12-28,8,2,3,3,5,-1,3,3,0
3222,2013-12-28,Man City,Crystal Palace,1,0,H,2013-12-28,3,1,1,1,2,0,6,3,3
3223,2013-12-28,Norwich,Man United,0,1,A,2013-12-28,1,4,3,3,-2,1,0,6,-6
3224,2013-12-28,West Ham,West Brom,3,3,D,2013-12-28,4,4,6,6,-2,-2,1,2,-1
3225,2013-12-29,Chelsea,Liverpool,2,1,H,2014-01-04,5,3,1,1,4,2,3,0,3
3226,2013-12-29,Everton,Southampton,2,1,H,2014-01-04,3,1,2,2,1,-1,3,0,3
3227,2013-12-29,Newcastle,Arsenal,0,1,A,2014-01-04,0,3,2,2,-2,1,0,3,-3
3228,2013-12-29,Tottenham,Stoke,3,0,H,2014-01-04,5,1,1,1,4,0,3,0,3
3229,2014-01-01,Arsenal,Cardiff,2,0,H,2014-01-04,3,0,0,0,3,0,3,0,3
3230,2014-01-01,Crystal Palace,Norwich,1,1,D,2014-01-04,1,1,1,1,0,0,1,1,0
3231,2014-01-01,Fulham,West Ham,2,1,H,2014-01-04,2,1,1,1,1,0,3,0,3
3232,2014-01-01,Liverpool,Hull,2,0,H,2014-01-04,3,0,2,2,1,-2,3,0,3
3233,2014-01-01,Man United,Tottenham,1,2,A,2014-01-04,1,5,2,2,-1,3,0,3,-3
3234,2014-01-01,Southampton,Chelsea,0,3,A,2014-01-04,1,5,5,5,-4,0,0,3,-3
3235,2014-01-01,Stoke,Everton,1,1,D,2014-01-04,1,3,4,4,-3,-1,1,1,0
3236,2014-01-01,Sunderland,Aston Villa,0,1,A,2014-01-04,0,1,1,1,-1,0,0,3,-3
3237,2014-01-01,Swansea,Man City,2,3,A,2014-01-04,2,3,3,3,-1,0,0,3,-3
3238,2014-01-01,West Brom,Newcastle,1,0,H,2014-01-04,1,0,0,0,1,0,3,0,3
3239,2014-01-11,Cardiff,West Ham,0,2,A,2014-01-11,0,2,2,2,-2,0,0,3,-3
3240,2014-01-11,Everton,Norwich,2,0,H,2014-01-11,2,0,0,0,2,0,3,0,3
3241,2014-01-11,Fulham,Sunderland,1,4,A,2014-01-11,1,4,4,4,-3,0,0,3,-3
3242,2014-01-11,Hull,Chelsea,0,2,A,2014-01-11,0,2,2,2,-2,0,0,3,-3
3243,2014-01-11,Man United,Swansea,2,0,H,2014-01-11,2,0,0,0,2,0,3,0,3
3244,2014-01-11,Southampton,West Brom,1,0,H,2014-01-11,1,0,0,0,1,0,3,0,3
3245,2014-01-11,Tottenham,Crystal Palace,2,0,H,2014-01-11,2,0,0,0,2,0,3,0,3
3246,2014-01-12,Newcastle,Man City,0,2,A,2014-01-18,3,6,3,3,0,3,0,3,-3
3247,2014-01-12,Stoke,Liverpool,3,5,A,2014-01-18,3,7,6,6,-3,1,0,3,-3
3248,2014-01-13,Aston Villa,Arsenal,1,2,A,2014-01-18,3,4,4,4,-1,0,0,3,-3
3249,2014-01-18,Arsenal,Fulham,2,0,H,2014-01-18,4,0,1,1,3,-1,3,0,3
3250,2014-01-18,Crystal Palace,Stoke,1,0,H,2014-01-18,1,3,0,0,1,3,3,0,3
3251,2014-01-18,Liverpool,Aston Villa,2,2,D,2014-01-18,7,3,5,5,2,-2,1,1,0
3252,2014-01-18,Man City,Cardiff,4,2,H,2014-01-18,6,2,2,2,4,0,3,0,3
3253,2014-01-18,Norwich,Hull,1,0,H,2014-01-18,1,0,0,0,1,0,3,0,3
3254,2014-01-18,Sunderland,Southampton,2,2,D,2014-01-18,2,2,2,2,0,0,1,1,0
3255,2014-01-18,West Ham,Newcastle,1,3,A,2014-01-18,1,3,3,3,-2,0,0,3,-3
3256,2014-01-19,Chelsea,Man United,3,1,H,2014-01-25,3,1,1,1,2,0,3,0,3
3257,2014-01-19,Swansea,Tottenham,1,3,A,2014-01-25,1,3,3,3,-2,0,0,3,-3
3258,2014-01-20,West Brom,Everton,1,1,D,2014-01-25,1,1,1,1,0,0,1,1,0
3259,2014-01-28,Crystal Palace,Hull,1,0,H,2014-02-01,1,1,0,0,1,1,3,0,3
3260,2014-01-28,Liverpool,Everton,4,0,H,2014-02-01,4,2,0,0,4,2,3,0,3
3261,2014-01-28,Man United,Cardiff,2,0,H,2014-02-01,3,2,2,2,1,0,3,0,3
3262,2014-01-28,Norwich,Newcastle,0,0,D,2014-02-01,1,0,2,2,-1,-2,1,1,0
3263,2014-01-28,Southampton,Arsenal,2,2,D,2014-02-01,5,2,2,2,3,0,1,1,0
3264,2014-01-28,Swansea,Fulham,2,0,H,2014-02-01,2,0,2,2,0,-2,3,0,3
3265,2014-01-29,Aston Villa,West Brom,4,3,H,2014-02-01,5,3,5,5,0,-2,3,0,3
3266,2014-01-29,Chelsea,West Ham,0,0,D,2014-02-01,0,2,0,0,0,2,1,1,0
3267,2014-01-29,Sunderland,Stoke,1,0,H,2014-02-01,4,2,0,0,4,2,3,0,3
3268,2014-01-29,Tottenham,Man City,1,5,A,2014-02-01,2,5,6,6,-4,-1,0,3,-3
3269,2014-02-01,Cardiff,Norwich,2,1,H,2014-02-01,2,1,3,3,-1,-2,3,0,3
3270,2014-02-01,Everton,Aston Villa,2,1,H,2014-02-01,2,5,5,5,-3,0,3,0,3
3271,2014-02-01,Fulham,Southampton,0,3,A,2014-02-01,0,5,5,5,-5,0,0,3,-3
3272,2014-02-01,Hull,Tottenham,1,1,D,2014-02-01,1,2,2,2,-1,0,1,1,0
3273,2014-02-01,Newcastle,Sunderland,0,3,A,2014-02-01,0,4,3,3,-3,1,0,3,-3
3274,2014-02-01,Stoke,Man United,2,1,H,2014-02-01,2,3,2,2,0,1,3,0,3
3275,2014-02-01,West Ham,Swansea,2,0,H,2014-02-01,2,2,0,0,2,2,3,0,3
3276,2014-02-02,Arsenal,Crystal Palace,2,0,H,2014-02-08,3,3,5,5,-2,-2,3,0,3
3277,2014-02-02,West Brom,Liverpool,1,1,D,2014-02-08,2,6,4,4,-2,2,1,1,0
3278,2014-02-03,Man City,Chelsea,0,1,A,2014-02-08,0,4,1,1,-1,3,0,3,-3
3279,2014-02-08,Aston Villa,West Ham,0,2,A,2014-02-08,0,2,2,2,-2,0,0,3,-3
3280,2014-02-08,Chelsea,Newcastle,3,0,H,2014-02-08,4,0,0,0,4,0,3,0,3
3281,2014-02-08,Crystal Palace,West Brom,3,1,H,2014-02-08,3,2,3,3,0,-1,3,0,3
3282,2014-02-08,Liverpool,Arsenal,5,1,H,2014-02-08,6,3,2,2,4,1,3,0,3
3283,2014-02-08,Norwich,Man City,0,0,D,2014-02-08,0,0,0,0,0,0,1,1,0
3284,2014-02-08,Southampton,Stoke,2,2,D,2014-02-08,2,2,2,2,0,0,1,1,0
3285,2014-02-08,Sunderland,Hull,0,2,A,2014-02-08,0,2,2,2,-2,0,0,3,-3
3286,2014-02-08,Swansea,Cardiff,3,0,H,2014-02-08,3,0,0,0,3,0,3,0,3
3287,2014-02-09,Man United,Fulham,2,2,D,2014-02-15,2,4,2,2,0,2,1,1,0
3288,2014-02-09,Tottenham,Everton,1,0,H,2014-02-15,5,0,0,0,5,0,3,0,3
3289,2014-02-11,Cardiff,Aston Villa,0,0,D,2014-02-15,0,0,0,0,0,0,1,1,0
3290,2014-02-11,Hull,Southampton,0,1,A,2014-02-15,0,1,1,1,-1,0,0,3,-3
3291,2014-02-11,West Brom,Chelsea,1,1,D,2014-02-15,1,1,1,1,0,0,1,1,0
3292,2014-02-11,West Ham,Norwich,2,0,H,2014-02-15,2,0,0,0,2,0,3,0,3
3293,2014-02-12,Arsenal,Man United,0,0,D,2014-02-15,0,2,0,0,0,2,1,1,0
3294,2014-02-12,Fulham,Liverpool,2,3,A,2014-02-15,4,3,5,5,-1,-2,0,3,-3
3295,2014-02-12,Newcastle,Tottenham,0,4,A,2014-02-15,0,5,4,4,-4,1,0,3,-3
3296,2014-02-12,Stoke,Swansea,1,1,D,2014-02-15,1,1,1,1,0,0,1,1,0
3297,2014-02-22,Arsenal,Sunderland,4,1,H,2014-02-22,4,1,1,1,3,0,3,0,3
3298,2014-02-22,Cardiff,Hull,0,4,A,2014-02-22,0,4,4,4,-4,0,0,3,-3
3299,2014-02-22,Chelsea,Everton,1,0,H,2014-02-22,1,0,0,0,1,0,3,0,3
3300,2014-02-22,Crystal Palace,Man United,0,2,A,2014-02-22,0,2,2,2,-2,0,0,3,-3
3301,2014-02-22,Man City,Stoke,1,0,H,2014-02-22,1,0,0,0,1,0,3,0,3
3302,2014-02-22,West Brom,Fulham,1,1,D,2014-02-22,1,1,1,1,0,0,1,1,0
3303,2014-02-22,West Ham,Southampton,3,1,H,2014-02-22,3,1,1,1,2,0,3,0,3
3304,2014-02-23,Liverpool,Swansea,4,3,H,2014-03-01,7,3,3,3,4,0,3,0,3
3305,2014-02-23,Newcastle,Aston Villa,1,0,H,2014-03-01,5,0,1,1,4,-1,3,0,3
3306,2014-02-23,Norwich,Tottenham,1,0,H,2014-03-01,1,0,0,0,1,0,3,0,3
3307,2014-03-01,Everton,West Ham,1,0,H,2014-03-01,1,0,0,0,1,0,3,0,3
3308,2014-03-01,Fulham,Chelsea,1,3,A,2014-03-01,1,3,3,3,-2,0,0,3,-3
3309,2014-03-01,Hull,Newcastle,1,4,A,2014-03-01,1,5,4,4,-3,1,0,3,-3
3310,2014-03-01,Southampton,Liverpool,0,3,A,2014-03-01,0,7,3,3,-3,4,0,3,-3
3311,2014-03-01,Stoke,Arsenal,1,0,H,2014-03-01,1,0,0,0,1,0,3,0,3
3312,2014-03-02,Aston Villa,Norwich,4,1,H,2014-03-08,4,2,1,1,3,1,3,0,3
3313,2014-03-02,Swansea,Crystal Palace,1,1,D,2014-03-08,1,1,1,1,0,0,1,1,0
3314,2014-03-02,Tottenham,Cardiff,1,0,H,2014-03-08,1,3,4,4,-3,-1,3,0,3
3315,2014-03-08,Cardiff,Fulham,3,1,H,2014-03-08,3,1,2,2,1,-1,3,0,3
3316,2014-03-08,Chelsea,Tottenham,4,0,H,2014-03-08,4,1,0,0,4,1,3,0,3
3317,2014-03-08,Crystal Palace,Southampton,0,1,A,2014-03-08,1,1,2,2,-1,-1,0,3,-3
3318,2014-03-08,Norwich,Stoke,1,1,D,2014-03-08,2,1,5,5,-3,-4,1,1,0
3319,2014-03-08,West Brom,Man United,0,3,A,2014-03-08,0,3,3,3,-3,0,0,3,-3
3320,2014-03-15,Aston Villa,Chelsea,1,0,H,2014-03-15,1,0,0,0,1,0,3,0,3
3321,2014-03-15,Everton,Cardiff,2,1,H,2014-03-15,2,1,1,1,1,0,3,0,3
3322,2014-03-15,Fulham,Newcastle,1,0,H,2014-03-15,1,0,0,0,1,0,3,0,3
3323,2014-03-15,Hull,Man City,0,2,A,2014-03-15,0,2,2,2,-2,0,0,3,-3
3324,2014-03-15,Southampton,Norwich,4,2,H,2014-03-15,4,2,2,2,2,0,3,0,3
3325,2014-03-15,Stoke,West Ham,3,1,H,2014-03-15,3,1,1,1,2,0,3,0,3
3326,2014-03-15,Sunderland,Crystal Palace,0,0,D,2014-03-15,0,0,0,0,0,0,1,1,0
3327,2014-03-15,Swansea,West Brom,1,2,A,2014-03-15,1,2,2,2,-1,0,0,3,-3
3328,2014-03-16,Man United,Liverpool,0,3,A,2014-03-22,2,9,3,3,-1,6,0,6,-6
3329,2014-03-16,Tottenham,Arsenal,0,1,A,2014-03-22,0,1,1,1,-1,0,0,3,-3
3330,2014-03-22,Cardiff,Liverpool,3,6,A,2014-03-22,3,9,6,6,-3,3,0,6,-6
3331,2014-03-22,Chelsea,Arsenal,6,0,H,2014-03-22,6,1,0,0,6,1,3,3,0
3332,2014-03-22,Everton,Swansea,3,2,H,2014-03-22,3,2,2,2,1,0,3,0,3
3333,2014-03-22,Hull,West Brom,2,0,H,2014-03-22,2,0,0,0,2,0,3,0,3
3334,2014-03-22,Man City,Fulham,5,0,H,2014-03-22,5,0,0,0,5,0,3,0,3
3335,2014-03-22,Newcastle,Crystal Palace,1,0,H,2014-03-22,1,0,0,0,1,0,3,0,3
3336,2014-03-22,Norwich,Sunderland,2,0,H,2014-03-22,2,0,0,0,2,0,3,0,3
3337,2014-03-22,West Ham,Man United,0,2,A,2014-03-22,0,2,2,2,-2,0,0,3,-3
3338,2014-03-23,Aston Villa,Stoke,1,4,A,2014-03-29,2,5,8,8,-6,-3,0,3,-3
3339,2014-03-23,Tottenham,Southampton,3,2,H,2014-03-29,3,6,2,2,1,4,3,0,3
3340,2014-03-25,Arsenal,Swansea,2,2,D,2014-03-29,3,5,3,3,0,2,2,1,1
3341,2014-03-25,Man United,Man City,0,3,A,2014-03-29,4,4,4,4,0,0,3,4,-1
3342,2014-03-25,Newcastle,Everton,0,3,A,2014-03-29,0,3,7,7,-7,-4,0,3,-3
3343,2014-03-26,Liverpool,Sunderland,2,1,H,2014-03-29,2,1,1,1,1,0,3,0,3
3344,2014-03-26,West Ham,Hull,2,1,H,2014-03-29,2,1,1,1,1,0,3,0,3
3345,2014-03-29,Arsenal,Man City,1,1,D,2014-03-29,3,4,3,3,0,1,2,4,-2
3346,2014-03-29,Crystal Palace,Chelsea,1,0,H,2014-03-29,1,0,0,0,1,0,3,0,3
3347,2014-03-29,Man United,Aston Villa,4,1,H,2014-03-29,4,2,4,4,0,-2,3,0,3
3348,2014-03-29,Southampton,Newcastle,4,0,H,2014-03-29,6,0,3,3,3,-3,3,0,3
3349,2014-03-29,Stoke,Hull,1,0,H,2014-03-29,5,1,1,1,4,0,3,0,3
3350,2014-03-29,Swansea,Norwich,3,0,H,2014-03-29,5,0,2,2,3,-2,3,0,3
3351,2014-03-29,West Brom,Cardiff,3,3,D,2014-03-29,3,3,3,3,0,0,1,1,0
3352,2014-03-30,Fulham,Everton,1,3,A,2014-04-05,3,3,4,4,-1,-1,0,3,-3
3353,2014-03-30,Liverpool,Tottenham,4,0,H,2014-04-05,4,0,0,0,4,0,3,0,3
3354,2014-03-31,Sunderland,West Ham,1,2,A,2014-04-05,1,2,2,2,-1,0,0,3,-3
3355,2014-04-05,Aston Villa,Fulham,1,2,A,2014-04-05,1,3,2,2,-1,1,0,3,-3
3356,2014-04-05,Cardiff,Crystal Palace,0,3,A,2014-04-05,0,3,3,3,-3,0,0,3,-3
3357,2014-04-05,Chelsea,Stoke,3,0,H,2014-04-05,3,0,0,0,3,0,3,0,3
3358,2014-04-05,Hull,Swansea,1,0,H,2014-04-05,1,0,0,0,1,0,3,0,3
3359,2014-04-05,Man City,Southampton,4,1,H,2014-04-05,4,1,1,1,3,0,3,0,3
3360,2014-04-05,Newcastle,Man United,0,4,A,2014-04-05,0,4,4,4,-4,0,0,3,-3
3361,2014-04-05,Norwich,West Brom,0,1,A,2014-04-05,0,1,1,1,-1,0,0,3,-3
3362,2014-04-06,Everton,Arsenal,3,0,H,2014-04-12,4,0,0,0,4,0,3,0,3
3363,2014-04-06,West Ham,Liverpool,1,2,A,2014-04-12,1,2,2,2,-1,0,0,3,-3
3364,2014-04-07,Tottenham,Sunderland,5,1,H,2014-04-12,8,1,4,4,4,-3,3,0,3
3365,2014-04-12,Crystal Palace,Aston Villa,1,0,H,2014-04-12,1,0,0,0,1,0,3,0,3
3366,2014-04-12,Fulham,Norwich,1,0,H,2014-04-12,1,0,0,0,1,0,3,0,3
3367,2014-04-12,Southampton,Cardiff,0,1,A,2014-04-12,0,1,1,1,-1,0,0,3,-3
3368,2014-04-12,Stoke,Newcastle,1,0,H,2014-04-12,1,0,0,0,1,0,3,0,3
3369,2014-04-12,Sunderland,Everton,0,1,A,2014-04-12,1,4,6,6,-5,-2,0,3,-3
3370,2014-04-12,West Brom,Tottenham,3,3,D,2014-04-12,3,8,3,3,0,5,1,1,0
3371,2014-04-13,Liverpool,Man City,3,2,H,2014-04-19,3,4,2,2,1,2,3,0,3
3372,2014-04-13,Swansea,Chelsea,0,1,A,2014-04-19,2,2,2,2,0,0,0,3,-3
3373,2014-04-15,Arsenal,West Ham,3,1,H,2014-04-19,3,1,1,1,2,0,3,0,3
3374,2014-04-16,Everton,Crystal Palace,2,3,A,2014-04-19,2,4,3,3,-1,1,0,6,-6
3375,2014-04-16,Man City,Sunderland,2,2,D,2014-04-19,4,4,5,5,-1,-1,1,4,-3
3376,2014-04-19,Aston Villa,Southampton,0,0,D,2014-04-19,0,0,0,0,0,0,1,1,0
3377,2014-04-19,Cardiff,Stoke,1,1,D,2014-04-19,1,1,1,1,0,0,1,1,0
3378,2014-04-19,Chelsea,Sunderland,1,2,A,2014-04-19,2,4,2,2,0,2,0,4,-4
3379,2014-04-19,Newcastle,Swansea,1,2,A,2014-04-19,1,2,2,2,-1,0,0,3,-3
3380,2014-04-19,Tottenham,Fulham,3,1,H,2014-04-19,3,1,1,1,2,0,3,0,3
3381,2014-04-19,West Ham,Crystal Palace,0,1,A,2014-04-19,1,4,4,4,-3,0,0,6,-6
3382,2014-04-20,Everton,Man United,2,0,H,2014-04-26,2,4,2,2,0,2,3,0,3
3383,2014-04-20,Hull,Arsenal,0,3,A,2014-04-26,2,3,5,5,-3,-2,0,3,-3
3384,2014-04-20,Norwich,Liverpool,2,3,A,2014-04-26,2,3,7,7,-5,-4,0,3,-3
3385,2014-04-21,Man City,West Brom,3,1,H,2014-04-26,3,2,1,1,2,1,3,0,3
3386,2014-04-26,Fulham,Hull,2,2,D,2014-04-26,2,2,2,2,0,0,1,1,0
3387,2014-04-26,Man United,Norwich,4,0,H,2014-04-26,4,2,2,2,2,0,3,0,3
3388,2014-04-26,Southampton,Everton,2,0,H,2014-04-26,2,2,0,0,2,2,3,0,3
3389,2014-04-26,Stoke,Tottenham,0,1,A,2014-04-26,0,1,1,1,-1,0,0,3,-3
3390,2014-04-26,Swansea,Aston Villa,4,1,H,2014-04-26,4,1,1,1,3,0,3,0,3
3391,2014-04-26,West Brom,West Ham,1,0,H,2014-04-26,2,0,3,3,-1,-3,3,0,3
3392,2014-04-27,Crystal Palace,Man City,0,2,A,2014-05-03,0,5,2,2,-2,3,0,6,-6
3393,2014-04-27,Liverpool,Chelsea,0,2,A,2014-05-03,0,2,2,2,-2,0,0,3,-3
3394,2014-04-27,Sunderland,Cardiff,4,0,H,2014-05-03,5,0,0,0,5,0,3,0,3
3395,2014-04-28,Arsenal,Newcastle,3,0,H,2014-05-03,3,3,0,0,3,3,3,0,3
3396,2014-05-03,Aston Villa,Hull,3,1,H,2014-05-03,3,1,1,1,2,0,3,0,3
3397,2014-05-03,Everton,Man City,2,3,A,2014-05-03,2,5,3,3,-1,2,0,6,-6
3398,2014-05-03,Man United,Sunderland,0,1,A,2014-05-03,0,5,1,1,-1,4,0,3,-3
3399,2014-05-03,Newcastle,Cardiff,3,0,H,2014-05-03,3,0,3,3,0,-3,3,0,3
3400,2014-05-03,Stoke,Fulham,4,1,H,2014-05-03,4,1,1,1,3,0,3,0,3
3401,2014-05-03,Swansea,Southampton,0,1,A,2014-05-03,0,1,1,1,-1,0,0,3,-3
3402,2014-05-03,West Ham,Tottenham,2,0,H,2014-05-03,2,0,0,0,2,0,3,0,3
3403,2014-05-04,Arsenal,West Brom,1,0,H,2014-05-10,1,0,0,0,1,0,3,0,3
3404,2014-05-04,Chelsea,Norwich,0,0,D,2014-05-10,0,0,0,0,0,0,1,1,0
3405,2014-05-05,Crystal Palace,Liverpool,3,3,D,2014-05-10,3,3,3,3,0,0,1,1,0
3406,2014-05-06,Man United,Hull,3,1,H,2014-05-10,3,1,1,1,2,0,3,0,3
3407,2014-05-07,Man City,Aston Villa,4,0,H,2014-05-10,4,0,0,0,4,0,3,0,3
3408,2014-05-07,Sunderland,West Brom,2,0,H,2014-05-10,2,0,0,0,2,0,3,0,3
3409,2014-05-11,Cardiff,Chelsea,1,2,A,2014-05-17,1,2,2,2,-1,0,0,3,-3
3410,2014-05-11,Fulham,Crystal Palace,2,2,D,2014-05-17,2,2,2,2,0,0,1,1,0
3411,2014-05-11,Hull,Everton,0,2,A,2014-05-17,0,2,2,2,-2,0,0,3,-3
3412,2014-05-11,Liverpool,Newcastle,2,1,H,2014-05-17,2,1,1,1,1,0,3,0,3
3413,2014-05-11,Man City,West Ham,2,0,H,2014-05-17,2,0,0,0,2,0,3,0,3
3414,2014-05-11,Norwich,Arsenal,0,2,A,2014-05-17,0,2,2,2,-2,0,0,3,-3
3415,2014-05-11,Southampton,Man United,1,1,D,2014-05-17,1,1,1,1,0,0,1,1,0
3416,2014-05-11,Sunderland,Swansea,1,3,A,2014-05-17,1,3,3,3,-2,0,0,3,-3
3417,2014-05-11,Tottenham,Aston Villa,3,0,H,2014-05-17,3,0,0,0,3,0,3,0,3
3418,2014-05-11,West Brom,Stoke,1,2,A,2014-05-17,1,2,2,2,-1,0,0,3,-3
3419,2014-08-16,Arsenal,Crystal Palace,2,1,H,2014-08-16,2,1,1,1,1,0,3,0,3
3420,2014-08-16,Leicester,Everton,2,2,D,2014-08-16,2,2,2,2,0,0,1,1,0
3421,2014-08-16,Man United,Swansea,1,2,A,2014-08-16,1,2,2,2,-1,0,0,3,-3
3422,2014-08-16,QPR,Hull,0,1,A,2014-08-16,0,1,1,1,-1,0,0,3,-3
3423,2014-08-16,Stoke,Aston Villa,0,1,A,2014-08-16,0,1,1,1,-1,0,0,3,-3
3424,2014-08-16,West Brom,Sunderland,2,2,D,2014-08-16,2,2,2,2,0,0,1,1,0
3425,2014-08-16,West Ham,Tottenham,0,1,A,2014-08-16,0,1,1,1,-1,0,0,3,-3
3426,2014-08-17,Liverpool,Southampton,2,1,H,2014-08-23,2,1,1,1,1,0,3,0,3
3427,2014-08-17,Newcastle,Man City,0,2,A,2014-08-23,0,2,2,2,-2,0,0,3,-3
3428,2014-08-18,Burnley,Chelsea,1,3,A,2014-08-23,1,5,4,4,-3,1,0,3,-3
3429,2014-08-23,Aston Villa,Newcastle,0,0,D,2014-08-23,0,0,0,0,0,0,1,1,0
3430,2014-08-23,Chelsea,Leicester,2,0,H,2014-08-23,5,0,1,1,4,-1,3,0,3
3431,2014-08-23,Crystal Palace,West Ham,1,3,A,2014-08-23,1,3,3,3,-2,0,0,3,-3
3432,2014-08-23,Everton,Arsenal,2,2,D,2014-08-23,2,2,2,2,0,0,1,1,0
3433,2014-08-23,Southampton,West Brom,0,0,D,2014-08-23,1,0,2,2,-1,-2,1,1,0
3434,2014-08-23,Swansea,Burnley,1,0,H,2014-08-23,1,1,0,0,1,1,3,0,3
3435,2014-08-24,Hull,Stoke,1,1,D,2014-08-30,1,2,1,1,0,1,1,4,-3
3436,2014-08-24,Sunderland,Man United,1,1,D,2014-08-30,1,1,2,2,-1,-1,1,2,-1
3437,2014-08-24,Tottenham,QPR,4,0,H,2014-08-30,4,1,0,0,4,1,3,0,3
3438,2014-08-25,Man City,Liverpool,3,1,H,2014-08-30,3,1,2,2,1,-1,3,0,3
3439,2014-08-30,Burnley,Man United,0,0,D,2014-08-30,0,1,0,0,0,1,1,2,-1
3440,2014-08-30,Everton,Chelsea,3,6,A,2014-08-30,3,6,6,6,-3,0,0,3,-3
3441,2014-08-30,Man City,Stoke,0,1,A,2014-08-30,3,2,2,2,1,0,3,4,-1
3442,2014-08-30,Newcastle,Crystal Palace,3,3,D,2014-08-30,3,3,3,3,0,0,1,1,0
3443,2014-08-30,QPR,Sunderland,1,0,H,2014-08-30,1,1,4,4,-3,-3,3,0,3
3444,2014-08-30,Swansea,West Brom,3,0,H,2014-08-30,3,0,0,0,3,0,3,0,3
3445,2014-08-30,West Ham,Southampton,1,3,A,2014-08-30,1,3,3,3,-2,0,0,3,-3
3446,2014-08-31,Aston Villa,Hull,2,1,H,2014-09-06,2,1,1,1,1,0,3,0,3
3447,2014-08-31,Leicester,Arsenal,1,1,D,2014-09-06,1,1,1,1,0,0,1,1,0
3448,2014-08-31,Tottenham,Liverpool,0,3,A,2014-09-06,0,3,3,3,-3,0,0,3,-3
3449,2014-09-13,Arsenal,Man City,2,2,D,2014-09-13,2,2,2,2,0,0,1,1,0
3450,2014-09-13,Chelsea,Swansea,4,2,H,2014-09-13,4,2,2,2,2,0,3,0,3
3451,2014-09-13,Crystal Palace,Burnley,0,0,D,2014-09-13,0,0,0,0,0,0,1,1,0
3452,2014-09-13,Liverpool,Aston Villa,0,1,A,2014-09-13,0,1,1,1,-1,0,0,3,-3
3453,2014-09-13,Southampton,Newcastle,4,0,H,2014-09-13,4,0,0,0,4,0,3,0,3
3454,2014-09-13,Stoke,Leicester,0,1,A,2014-09-13,0,1,1,1,-1,0,0,3,-3
3455,2014-09-13,Sunderland,Tottenham,2,2,D,2014-09-13,2,2,2,2,0,0,1,1,0
3456,2014-09-13,West Brom,Everton,0,2,A,2014-09-13,0,2,2,2,-2,0,0,3,-3
3457,2014-09-14,Man United,QPR,4,0,H,2014-09-20,4,2,0,0,4,2,3,0,3
3458,2014-09-15,Hull,West Ham,2,2,D,2014-09-20,4,5,4,4,0,1,1,1,0
3459,2014-09-20,Aston Villa,Arsenal,0,3,A,2014-09-20,0,3,3,3,-3,0,0,3,-3
3460,2014-09-20,Burnley,Sunderland,0,0,D,2014-09-20,0,0,0,0,0,0,1,1,0
3461,2014-09-20,Newcastle,Hull,2,2,D,2014-09-20,2,4,2,2,0,2,1,1,0
3462,2014-09-20,QPR,Stoke,2,2,D,2014-09-20,2,2,6,6,-4,-4,1,1,0
3463,2014-09-20,Swansea,Southampton,0,1,A,2014-09-20,0,1,1,1,-1,0,0,3,-3
3464,2014-09-20,West Ham,Liverpool,3,1,H,2014-09-20,5,1,3,3,2,-2,3,0,3
3465,2014-09-21,Everton,Crystal Palace,2,3,A,2014-09-27,3,5,4,4,-1,1,0,3,-3
3466,2014-09-21,Leicester,Man United,5,3,H,2014-09-27,5,5,5,5,0,0,3,0,3
3467,2014-09-21,Man City,Chelsea,1,1,D,2014-09-27,5,4,3,3,2,1,1,1,0
3468,2014-09-21,Tottenham,West Brom,0,1,A,2014-09-27,1,1,2,2,-1,-1,0,3,-3
3469,2014-09-27,Arsenal,Tottenham,1,1,D,2014-09-27,1,1,1,1,0,0,1,1,0
3470,2014-09-27,Chelsea,Aston Villa,3,0,H,2014-09-27,4,0,1,1,3,-1,3,0,3
3471,2014-09-27,Crystal Palace,Leicester,2,0,H,2014-09-27,5,5,2,2,3,3,3,0,3
3472,2014-09-27,Hull,Man City,2,4,A,2014-09-27,2,5,4,4,-2,1,0,3,-3
3473,2014-09-27,Liverpool,Everton,1,1,D,2014-09-27,1,3,1,1,0,2,1,1,0
3474,2014-09-27,Man United,West Ham,2,1,H,2014-09-27,5,1,6,6,-1,-5,3,0,3
3475,2014-09-27,Southampton,QPR,2,1,H,2014-09-27,2,1,1,1,1,0,3,0,3
3476,2014-09-27,Sunderland,Swansea,0,0,D,2014-09-27,0,0,0,0,0,0,1,1,0
3477,2014-09-28,West Brom,Burnley,4,0,H,2014-10-04,5,2,2,2,3,0,3,1,2
3478,2014-09-29,Stoke,Newcastle,1,0,H,2014-10-04,2,2,3,3,-1,-1,3,1,2
3479,2014-10-04,Aston Villa,Man City,0,2,A,2014-10-04,0,2,2,2,-2,0,0,3,-3
3480,2014-10-04,Hull,Crystal Palace,2,0,H,2014-10-04,2,0,0,0,2,0,3,0,3
3481,2014-10-04,Leicester,Burnley,2,2,D,2014-10-04,2,2,2,2,0,0,1,1,0
3482,2014-10-04,Liverpool,West Brom,2,1,H,2014-10-04,2,5,1,1,1,4,3,0,3
3483,2014-10-04,Sunderland,Stoke,3,1,H,2014-10-04,3,2,1,1,2,1,3,0,3
3484,2014-10-04,Swansea,Newcastle,2,2,D,2014-10-04,2,2,2,2,0,0,1,1,0
3485,2014-10-05,Chelsea,Arsenal,2,0,H,2014-10-11,2,0,0,0,2,0,3,0,3
3486,2014-10-05,Man United,Everton,2,1,H,2014-10-11,2,1,1,1,1,0,3,0,3
3487,2014-10-05,Tottenham,Southampton,1,0,H,2014-10-11,1,0,0,0,1,0,3,0,3
3488,2014-10-05,West Ham,QPR,2,0,H,2014-10-11,2,0,0,0,2,0,3,0,3
3489,2014-10-18,Arsenal,Hull,2,2,D,2014-10-18,2,2,2,2,0,0,1,1,0
3490,2014-10-18,Burnley,West Ham,1,3,A,2014-10-18,1,3,3,3,-2,0,0,3,-3
3491,2014-10-18,Crystal Palace,Chelsea,1,2,A,2014-10-18,1,2,2,2,-1,0,0,3,-3
3492,2014-10-18,Everton,Aston Villa,3,0,H,2014-10-18,3,0,0,0,3,0,3,0,3
3493,2014-10-18,Man City,Tottenham,4,1,H,2014-10-18,4,1,1,1,3,0,3,0,3
3494,2014-10-18,Newcastle,Leicester,1,0,H,2014-10-18,1,0,0,0,1,0,3,0,3
3495,2014-10-18,Southampton,Sunderland,8,0,H,2014-10-18,8,0,0,0,8,0,3,0,3
3496,2014-10-19,QPR,Liverpool,2,3,A,2014-10-25,2,3,3,3,-1,0,0,3,-3
3497,2014-10-19,Stoke,Swansea,2,1,H,2014-10-25,2,3,2,2,0,1,3,0,3
3498,2014-10-20,West Brom,Man United,2,2,D,2014-10-25,4,2,4,4,0,-2,2,1,1
3499,2014-10-25,Liverpool,Hull,0,0,D,2014-10-25,3,0,2,2,1,-2,1,1,0
3500,2014-10-25,Southampton,Stoke,1,0,H,2014-10-25,1,2,0,0,1,2,3,0,3
3501,2014-10-25,Sunderland,Arsenal,0,2,A,2014-10-25,0,2,2,2,-2,0,0,3,-3
3502,2014-10-25,Swansea,Leicester,2,0,H,2014-10-25,3,0,2,2,1,-2,3,0,3
3503,2014-10-25,West Brom,Crystal Palace,2,2,D,2014-10-25,4,2,4,4,0,-2,2,1,1
3504,2014-10-25,West Ham,Man City,2,1,H,2014-10-25,2,1,1,1,1,0,3,0,3
3505,2014-10-26,Burnley,Everton,1,3,A,2014-11-01,1,3,6,6,-5,-3,0,3,-3
3506,2014-10-26,Man United,Chelsea,1,1,D,2014-11-01,1,3,1,1,0,2,1,1,0
3507,2014-10-26,Tottenham,Newcastle,1,2,A,2014-11-01,1,3,2,2,-1,1,0,3,-3
3508,2014-10-27,QPR,Aston Villa,2,0,H,2014-11-01,3,0,2,2,1,-2,3,0,3
3509,2014-11-01,Arsenal,Burnley,3,0,H,2014-11-01,3,1,0,0,3,1,3,0,3
3510,2014-11-01,Chelsea,QPR,2,1,H,2014-11-01,3,3,2,2,1,1,3,0,3
3511,2014-11-01,Everton,Swansea,0,0,D,2014-11-01,3,0,1,1,2,-1,1,1,0
3512,2014-11-01,Hull,Southampton,0,1,A,2014-11-01,0,1,1,1,-1,0,0,3,-3
3513,2014-11-01,Leicester,West Brom,0,1,A,2014-11-01,0,1,1,1,-1,0,0,3,-3
3514,2014-11-01,Newcastle,Liverpool,1,0,H,2014-11-01,3,0,1,1,2,-1,3,0,3
3515,2014-11-01,Stoke,West Ham,2,2,D,2014-11-01,2,2,2,2,0,0,1,1,0
3516,2014-11-02,Aston Villa,Tottenham,1,2,A,2014-11-08,1,2,2,2,-1,0,0,3,-3
3517,2014-11-02,Man City,Man United,1,0,H,2014-11-08,3,1,2,2,1,-1,3,0,3
3518,2014-11-03,Crystal Palace,Sunderland,1,3,A,2014-11-08,1,3,4,4,-3,-1,0,3,-3
3519,2014-11-08,Burnley,Hull,1,0,H,2014-11-08,1,0,0,0,1,0,3,0,3
3520,2014-11-08,Liverpool,Chelsea,1,2,A,2014-11-08,1,2,2,2,-1,0,0,3,-3
3521,2014-11-08,Man United,Crystal Palace,1,0,H,2014-11-08,1,1,1,1,0,0,3,0,3
3522,2014-11-08,QPR,Man City,2,2,D,2014-11-08,2,3,2,2,0,1,1,1,0
3523,2014-11-08,Southampton,Leicester,2,0,H,2014-11-08,2,0,0,0,2,0,3,0,3
3524,2014-11-08,West Ham,Aston Villa,0,0,D,2014-11-08,0,1,0,0,0,1,1,1,0
3525,2014-11-09,Sunderland,Everton,1,1,D,2014-11-15,1,1,1,1,0,0,1,1,0
3526,2014-11-09,Swansea,Arsenal,2,1,H,2014-11-15,2,1,1,1,1,0,3,0,3
3527,2014-11-09,Tottenham,Stoke,1,2,A,2014-11-15,1,2,2,2,-1,0,0,3,-3
3528,2014-11-09,West Brom,Newcastle,0,2,A,2014-11-15,0,2,2,2,-2,0,0,3,-3
3529,2014-11-22,Arsenal,Man United,1,2,A,2014-11-22,1,2,2,2,-1,0,0,3,-3
3530,2014-11-22,Chelsea,West Brom,2,0,H,2014-11-22,2,0,0,0,2,0,3,0,3
3531,2014-11-22,Everton,West Ham,2,1,H,2014-11-22,2,1,1,1,1,0,3,0,3
3532,2014-11-22,Leicester,Sunderland,0,0,D,2014-11-22,0,0,0,0,0,0,1,1,0
3533,2014-11-22,Man City,Swansea,2,1,H,2014-11-22,2,1,1,1,1,0,3,0,3
3534,2014-11-22,Newcastle,QPR,1,0,H,2014-11-22,1,0,0,0,1,0,3,0,3
3535,2014-11-22,Stoke,Burnley,1,2,A,2014-11-22,1,2,2,2,-1,0,0,3,-3
3536,2014-11-23,Crystal Palace,Liverpool,3,1,H,2014-11-29,4,2,2,2,2,0,3,0,3
3537,2014-11-23,Hull,Tottenham,1,2,A,2014-11-29,1,2,5,5,-4,-3,0,3,-3
3538,2014-11-24,Aston Villa,Southampton,1,1,D,2014-11-29,2,1,2,2,0,-1,1,1,0
3539,2014-11-29,Burnley,Aston Villa,1,1,D,2014-11-29,1,2,1,1,0,1,1,1,0
3540,2014-11-29,Liverpool,Stoke,1,0,H,2014-11-29,2,0,3,3,-1,-3,3,0,3
3541,2014-11-29,Man United,Hull,3,0,H,2014-11-29,3,1,0,0,3,1,3,0,3
3542,2014-11-29,QPR,Leicester,3,2,H,2014-11-29,3,2,2,2,1,0,3,0,3
3543,2014-11-29,Sunderland,Chelsea,0,0,D,2014-11-29,0,0,0,0,0,0,1,1,0
3544,2014-11-29,Swansea,Crystal Palace,1,1,D,2014-11-29,1,4,1,1,0,3,1,1,0
3545,2014-11-29,West Brom,Arsenal,0,1,A,2014-11-29,0,1,1,1,-1,0,0,3,-3
3546,2014-11-29,West Ham,Newcastle,1,0,H,2014-11-29,1,0,0,0,1,0,3,0,3
3547,2014-11-30,Southampton,Man City,0,3,A,2014-12-06,0,8,4,4,-4,4,0,6,-6
3548,2014-11-30,Tottenham,Everton,2,1,H,2014-12-06,2,2,4,4,-2,-2,4,0,4
3549,2014-12-02,Burnley,Newcastle,1,1,D,2014-12-06,1,3,3,3,-2,0,1,1,0
3550,2014-12-02,Crystal Palace,Aston Villa,0,1,A,2014-12-06,0,1,1,1,-1,0,0,3,-3
3551,2014-12-02,Leicester,Liverpool,1,3,A,2014-12-06,1,3,3,3,-2,0,0,3,-3
3552,2014-12-02,Man United,Stoke,2,1,H,2014-12-06,2,4,1,1,1,3,3,0,3
3553,2014-12-02,Swansea,QPR,2,0,H,2014-12-06,2,2,0,0,2,2,3,0,3
3554,2014-12-02,West Brom,West Ham,1,2,A,2014-12-06,1,2,2,2,-1,0,0,3,-3
3555,2014-12-03,Arsenal,Southampton,1,0,H,2014-12-06,3,0,3,3,0,-3,3,0,3
3556,2014-12-03,Chelsea,Tottenham,3,0,H,2014-12-06,4,2,2,2,2,0,3,0,3
3557,2014-12-03,Everton,Hull,1,1,D,2014-12-06,2,1,4,4,-2,-3,1,1,0
3558,2014-12-03,Sunderland,Man City,1,4,A,2014-12-06,1,8,4,4,-3,4,0,6,-6
3559,2014-12-06,Hull,West Brom,0,0,D,2014-12-06,1,1,1,1,0,0,1,1,0
3560,2014-12-06,Liverpool,Sunderland,0,0,D,2014-12-06,3,1,1,1,2,0,1,1,0
3561,2014-12-06,Man City,Everton,1,0,H,2014-12-06,8,2,1,1,7,1,3,0,3
3562,2014-12-06,Newcastle,Chelsea,2,1,H,2014-12-06,3,4,2,2,1,2,3,0,3
3563,2014-12-06,QPR,Burnley,2,0,H,2014-12-06,2,1,2,2,0,-1,3,0,3
3564,2014-12-06,Stoke,Arsenal,3,2,H,2014-12-06,4,3,4,4,0,-1,3,0,3
3565,2014-12-06,Tottenham,Crystal Palace,0,0,D,2014-12-06,2,0,4,4,-2,-4,4,1,3
3566,2014-12-07,Aston Villa,Leicester,2,1,H,2014-12-13,2,1,2,2,0,-1,3,0,3
3567,2014-12-07,West Ham,Swansea,3,1,H,2014-12-13,4,1,2,2,2,-1,3,0,3
3568,2014-12-08,Southampton,Man United,1,2,A,2014-12-13,1,2,3,3,-2,-1,0,3,-3
3569,2014-12-13,Arsenal,Newcastle,4,1,H,2014-12-13,4,1,1,1,3,0,3,0,3
3570,2014-12-13,Burnley,Southampton,1,0,H,2014-12-13,1,1,0,0,1,1,3,0,3
3571,2014-12-13,Chelsea,Hull,2,0,H,2014-12-13,2,0,0,0,2,0,3,0,3
3572,2014-12-13,Crystal Palace,Stoke,1,1,D,2014-12-13,1,1,1,1,0,0,1,1,0
3573,2014-12-13,Leicester,Man City,0,1,A,2014-12-13,1,1,3,3,-2,-2,0,3,-3
3574,2014-12-13,Sunderland,West Ham,1,1,D,2014-12-13,1,4,1,1,0,3,1,1,0
3575,2014-12-13,West Brom,Aston Villa,1,0,H,2014-12-13,1,2,0,0,1,2,3,0,3
3576,2014-12-14,Man United,Liverpool,3,0,H,2014-12-20,4,0,1,1,3,-1,3,0,3
3577,2014-12-14,Swansea,Tottenham,1,2,A,2014-12-20,2,4,2,2,0,2,0,3,-3
3578,2014-12-15,Everton,QPR,3,1,H,2014-12-20,3,4,4,4,-1,0,3,0,3
3579,2014-12-20,Aston Villa,Man United,1,1,D,2014-12-20,1,4,1,1,0,3,1,1,0
3580,2014-12-20,Hull,Swansea,0,1,A,2014-12-20,0,2,1,1,-1,1,0,3,-3
3581,2014-12-20,Man City,Crystal Palace,3,0,H,2014-12-20,3,0,0,0,3,0,3,0,3
3582,2014-12-20,QPR,West Brom,3,2,H,2014-12-20,4,2,5,5,-1,-3,3,0,3
3583,2014-12-20,Southampton,Everton,3,0,H,2014-12-20,3,3,0,0,3,3,3,0,3
3584,2014-12-20,Tottenham,Burnley,2,1,H,2014-12-20,4,1,2,2,2,-1,3,0,3
3585,2014-12-20,West Ham,Leicester,2,0,H,2014-12-20,2,0,0,0,2,0,3,0,3
3586,2014-12-21,Liverpool,Arsenal,2,2,D,2014-12-27,3,4,2,2,1,2,1,1,0
3587,2014-12-21,Newcastle,Sunderland,0,1,A,2014-12-27,1,2,4,4,-3,-2,0,3,-3
3588,2014-12-22,Stoke,Chelsea,0,2,A,2014-12-27,1,4,2,2,-1,2,0,3,-3
3589,2014-12-26,Arsenal,QPR,2,1,H,2014-12-27,4,1,3,3,1,-2,3,0,3
3590,2014-12-26,Burnley,Liverpool,0,1,A,2014-12-27,0,3,1,1,-1,2,0,3,-3
3591,2014-12-26,Chelsea,West Ham,2,0,H,2014-12-27,4,0,0,0,4,0,3,0,3
3592,2014-12-26,Crystal Palace,Southampton,1,3,A,2014-12-27,1,3,3,3,-2,0,0,3,-3
3593,2014-12-26,Everton,Stoke,0,1,A,2014-12-27,0,1,1,1,-1,0,0,3,-3
3594,2014-12-26,Leicester,Tottenham,1,2,A,2014-12-27,1,2,2,2,-1,0,0,3,-3
3595,2014-12-26,Man United,Newcastle,3,1,H,2014-12-27,3,1,1,1,2,0,3,0,3
3596,2014-12-26,Sunderland,Hull,1,3,A,2014-12-27,2,3,3,3,-1,0,0,3,-3
3597,2014-12-26,Swansea,Aston Villa,1,0,H,2014-12-27,1,0,0,0,1,0,3,0,3
3598,2014-12-26,West Brom,Man City,1,3,A,2014-12-27,1,3,3,3,-2,0,0,3,-3
3599,2014-12-28,Aston Villa,Sunderland,0,0,D,2015-01-03,0,2,0,0,0,2,2,1,1
3600,2014-12-28,Hull,Leicester,0,1,A,2015-01-03,2,3,1,1,1,2,3,4,-1
3601,2014-12-28,Man City,Burnley,2,2,D,2015-01-03,5,5,4,4,1,1,4,2,2
3602,2014-12-28,Newcastle,Everton,3,2,H,2015-01-03,6,2,5,5,1,-3,4,0,4
3603,2014-12-28,QPR,Crystal Palace,0,0,D,2015-01-03,1,0,1,1,0,-1,2,2,0
3604,2014-12-28,Southampton,Chelsea,1,1,D,2015-01-03,3,4,1,1,2,3,4,1,3
3605,2014-12-28,Stoke,West Brom,2,0,H,2015-01-03,3,1,1,1,2,0,4,1,3
3606,2014-12-28,Tottenham,Man United,0,0,D,2015-01-03,5,1,3,3,2,-2,4,2,2
3607,2014-12-28,West Ham,Arsenal,1,2,A,2015-01-03,2,2,3,3,-1,-1,1,3,-2
3608,2014-12-29,Liverpool,Swansea,4,1,H,2015-01-03,6,2,3,3,3,-1,4,1,3
3609,2015-01-01,Aston Villa,Crystal Palace,0,0,D,2015-01-03,0,0,0,0,0,0,2,2,0
3610,2015-01-01,Hull,Everton,2,0,H,2015-01-03,2,2,1,1,1,1,3,0,3
3611,2015-01-01,Liverpool,Leicester,2,2,D,2015-01-03,6,3,3,3,3,0,4,4,0
3612,2015-01-01,Man City,Sunderland,3,2,H,2015-01-03,5,2,4,4,1,-2,4,1,3
3613,2015-01-01,Newcastle,Burnley,3,3,D,2015-01-03,6,5,5,5,1,0,4,2,2
3614,2015-01-01,QPR,Swansea,1,1,D,2015-01-03,1,2,1,1,0,1,2,1,1
3615,2015-01-01,Southampton,Arsenal,2,0,H,2015-01-03,3,2,1,1,2,1,4,3,1
3616,2015-01-01,Stoke,Man United,1,1,D,2015-01-03,3,1,1,1,2,0,4,2,2
3617,2015-01-01,Tottenham,Chelsea,5,3,H,2015-01-03,5,4,3,3,2,1,4,1,3
3618,2015-01-01,West Ham,West Brom,1,1,D,2015-01-03,2,1,3,3,-1,-2,1,1,0
3619,2015-01-10,Burnley,QPR,2,1,H,2015-01-10,2,1,1,1,1,0,3,0,3
3620,2015-01-10,Chelsea,Newcastle,2,0,H,2015-01-10,2,0,0,0,2,0,3,0,3
3621,2015-01-10,Crystal Palace,Tottenham,2,1,H,2015-01-10,2,1,1,1,1,0,3,0,3
3622,2015-01-10,Everton,Man City,1,1,D,2015-01-10,1,1,1,1,0,0,1,1,0
3623,2015-01-10,Leicester,Aston Villa,1,0,H,2015-01-10,1,0,0,0,1,0,3,0,3
3624,2015-01-10,Sunderland,Liverpool,0,1,A,2015-01-10,0,1,1,1,-1,0,0,3,-3
3625,2015-01-10,Swansea,West Ham,1,1,D,2015-01-10,1,1,1,1,0,0,1,1,0
3626,2015-01-10,West Brom,Hull,1,0,H,2015-01-10,1,0,0,0,1,0,3,0,3
3627,2015-01-11,Arsenal,Stoke,3,0,H,2015-01-17,3,1,0,0,3,1,3,3,0
3628,2015-01-11,Man United,Southampton,0,1,A,2015-01-17,2,3,1,1,1,2,0,6,-6
3629,2015-01-17,Aston Villa,Liverpool,0,2,A,2015-01-17,0,2,2,2,-2,0,0,3,-3
3630,2015-01-17,Burnley,Crystal Palace,2,3,A,2015-01-17,2,3,3,3,-1,0,0,3,-3
3631,2015-01-17,Leicester,Stoke,0,1,A,2015-01-17,0,1,1,1,-1,0,0,3,-3
3632,2015-01-17,Newcastle,Southampton,1,2,A,2015-01-17,1,3,2,2,-1,1,0,6,-6
3633,2015-01-17,QPR,Man United,0,2,A,2015-01-17,0,2,2,2,-2,0,0,3,-3
3634,2015-01-17,Swansea,Chelsea,0,5,A,2015-01-17,0,5,5,5,-5,0,0,3,-3
3635,2015-01-17,Tottenham,Sunderland,2,1,H,2015-01-17,2,1,1,1,1,0,3,0,3
3636,2015-01-18,Man City,Arsenal,0,2,A,2015-01-24,0,2,2,2,-2,0,0,3,-3
3637,2015-01-18,West Ham,Hull,3,0,H,2015-01-24,3,0,0,0,3,0,3,0,3
3638,2015-01-19,Everton,West Brom,0,0,D,2015-01-24,0,0,0,0,0,0,1,1,0
3639,2015-01-31,Chelsea,Man City,1,1,D,2015-01-31,1,1,1,1,0,0,1,1,0
3640,2015-01-31,Crystal Palace,Everton,0,1,A,2015-01-31,0,1,1,1,-1,0,0,3,-3
3641,2015-01-31,Hull,Newcastle,0,3,A,2015-01-31,0,3,3,3,-3,0,0,3,-3
3642,2015-01-31,Liverpool,West Ham,2,0,H,2015-01-31,2,0,0,0,2,0,3,0,3
3643,2015-01-31,Man United,Leicester,3,1,H,2015-01-31,3,1,1,1,2,0,3,0,3
3644,2015-01-31,Stoke,QPR,3,1,H,2015-01-31,3,1,1,1,2,0,3,0,3
3645,2015-01-31,Sunderland,Burnley,2,0,H,2015-01-31,2,0,0,0,2,0,3,0,3
3646,2015-01-31,West Brom,Tottenham,0,3,A,2015-01-31,0,3,3,3,-3,0,0,3,-3
3647,2015-02-01,Arsenal,Aston Villa,5,0,H,2015-02-07,6,1,2,2,4,-1,3,0,3
3648,2015-02-01,Southampton,Swansea,0,1,A,2015-02-07,1,2,1,1,0,1,0,3,-3
3649,2015-02-07,Aston Villa,Chelsea,1,2,A,2015-02-07,1,2,7,7,-6,-5,0,3,-3
3650,2015-02-07,Everton,Liverpool,0,0,D,2015-02-07,0,0,0,0,0,0,1,1,0
3651,2015-02-07,Leicester,Crystal Palace,0,1,A,2015-02-07,0,1,1,1,-1,0,0,3,-3
3652,2015-02-07,Man City,Hull,1,1,D,2015-02-07,1,1,1,1,0,0,1,1,0
3653,2015-02-07,QPR,Southampton,0,1,A,2015-02-07,0,1,1,1,-1,0,0,3,-3
3654,2015-02-07,Swansea,Sunderland,1,1,D,2015-02-07,2,1,1,1,1,0,1,1,0
3655,2015-02-07,Tottenham,Arsenal,2,1,H,2015-02-07,2,6,1,1,1,5,3,0,3
3656,2015-02-08,Burnley,West Brom,2,2,D,2015-02-14,3,4,5,5,-2,-1,1,1,0
3657,2015-02-08,Newcastle,Stoke,1,1,D,2015-02-14,2,2,2,2,0,0,1,1,0
3658,2015-02-08,West Ham,Man United,1,1,D,2015-02-14,1,4,1,1,0,3,1,1,0
3659,2015-02-10,Arsenal,Leicester,2,1,H,2015-02-14,2,1,1,1,1,0,3,0,3
3660,2015-02-10,Hull,Aston Villa,2,0,H,2015-02-14,2,0,0,0,2,0,3,0,3
3661,2015-02-10,Liverpool,Tottenham,3,2,H,2015-02-14,3,2,2,2,1,0,3,0,3
3662,2015-02-10,Sunderland,QPR,0,2,A,2015-02-14,0,2,2,2,-2,0,0,3,-3
3663,2015-02-11,Chelsea,Everton,1,0,H,2015-02-14,1,0,0,0,1,0,3,0,3
3664,2015-02-11,Crystal Palace,Newcastle,1,1,D,2015-02-14,1,2,1,1,0,1,1,1,0
3665,2015-02-11,Man United,Burnley,3,1,H,2015-02-14,4,3,2,2,2,1,3,0,3
3666,2015-02-11,Southampton,West Ham,0,0,D,2015-02-14,0,1,0,0,0,1,1,1,0
3667,2015-02-11,Stoke,Man City,1,4,A,2015-02-14,2,4,5,5,-3,-1,0,3,-3
3668,2015-02-11,West Brom,Swansea,2,0,H,2015-02-14,4,0,2,2,2,-2,3,0,3
3669,2015-02-21,Aston Villa,Stoke,1,2,A,2015-02-21,1,2,2,2,-1,0,0,3,-3
3670,2015-02-21,Chelsea,Burnley,1,1,D,2015-02-21,1,1,1,1,0,0,1,1,0
3671,2015-02-21,Crystal Palace,Arsenal,1,2,A,2015-02-21,1,2,2,2,-1,0,0,3,-3
3672,2015-02-21,Hull,QPR,2,1,H,2015-02-21,2,1,1,1,1,0,3,0,3
3673,2015-02-21,Man City,Newcastle,5,0,H,2015-02-21,5,0,0,0,5,0,3,0,3
3674,2015-02-21,Sunderland,West Brom,0,0,D,2015-02-21,0,0,0,0,0,0,1,1,0
3675,2015-02-21,Swansea,Man United,2,1,H,2015-02-21,2,1,1,1,1,0,3,0,3
3676,2015-02-22,Everton,Leicester,2,2,D,2015-02-28,2,2,2,2,0,0,1,1,0
3677,2015-02-22,Southampton,Liverpool,0,2,A,2015-02-28,0,2,3,3,-3,-1,0,3,-3
3678,2015-02-22,Tottenham,West Ham,2,2,D,2015-02-28,2,3,2,2,0,1,1,1,0
3679,2015-02-28,Burnley,Swansea,0,1,A,2015-02-28,0,1,1,1,-1,0,0,3,-3
3680,2015-02-28,Man United,Sunderland,2,0,H,2015-02-28,2,0,0,0,2,0,3,0,3
3681,2015-02-28,Newcastle,Aston Villa,1,0,H,2015-02-28,1,0,0,0,1,0,3,0,3
3682,2015-02-28,Stoke,Hull,1,0,H,2015-02-28,1,0,0,0,1,0,3,0,3
3683,2015-02-28,West Brom,Southampton,1,0,H,2015-02-28,1,0,0,0,1,0,3,0,3
3684,2015-02-28,West Ham,Crystal Palace,1,3,A,2015-02-28,3,3,5,5,-2,-2,0,3,-3
3685,2015-03-01,Arsenal,Everton,2,0,H,2015-03-07,4,0,1,1,3,-1,3,0,3
3686,2015-03-01,Liverpool,Man City,2,1,H,2015-03-07,4,3,1,1,3,2,6,0,6
3687,2015-03-03,Aston Villa,West Brom,2,1,H,2015-03-07,2,1,1,1,1,0,3,0,3
3688,2015-03-03,Hull,Sunderland,1,1,D,2015-03-07,1,1,1,1,0,0,1,1,0
3689,2015-03-03,Southampton,Crystal Palace,1,0,H,2015-03-07,1,0,0,0,1,0,3,0,3
3690,2015-03-04,Liverpool,Burnley,2,0,H,2015-03-07,4,0,1,1,3,-1,6,0,6
3691,2015-03-04,Man City,Leicester,2,0,H,2015-03-07,3,0,2,2,1,-2,3,0,3
3692,2015-03-04,Newcastle,Man United,0,1,A,2015-03-07,0,1,1,1,-1,0,0,3,-3
3693,2015-03-04,QPR,Arsenal,1,2,A,2015-03-07,2,4,4,4,-2,0,0,3,-3
3694,2015-03-04,Stoke,Everton,2,0,H,2015-03-07,2,0,0,0,2,0,3,0,3
3695,2015-03-04,Tottenham,Swansea,3,2,H,2015-03-07,5,2,3,3,2,-1,3,0,3
3696,2015-03-04,West Ham,Chelsea,0,1,A,2015-03-07,0,1,1,1,-1,0,0,3,-3
3697,2015-03-07,QPR,Tottenham,1,2,A,2015-03-07,2,5,4,4,-2,1,0,3,-3
3698,2015-03-14,Arsenal,West Ham,3,0,H,2015-03-14,3,0,0,0,3,0,3,0,3
3699,2015-03-14,Burnley,Man City,1,0,H,2015-03-14,1,0,0,0,1,0,3,0,3
3700,2015-03-14,Crystal Palace,QPR,3,1,H,2015-03-14,3,1,1,1,2,0,3,0,3
3701,2015-03-14,Leicester,Hull,0,0,D,2015-03-14,0,0,0,0,0,0,1,1,0
3702,2015-03-14,Sunderland,Aston Villa,0,4,A,2015-03-14,0,4,4,4,-4,0,0,3,-3
3703,2015-03-14,West Brom,Stoke,1,0,H,2015-03-14,1,0,0,0,1,0,3,0,3
3704,2015-03-15,Chelsea,Southampton,1,1,D,2015-03-21,1,3,1,1,0,2,1,1,0
3705,2015-03-15,Everton,Newcastle,3,0,H,2015-03-21,3,1,0,0,3,1,3,0,3
3706,2015-03-15,Man United,Tottenham,3,0,H,2015-03-21,3,4,0,0,3,4,3,0,3
3707,2015-03-16,Swansea,Liverpool,0,1,A,2015-03-21,1,1,1,1,0,0,0,3,-3
3708,2015-03-21,Aston Villa,Swansea,0,1,A,2015-03-21,0,1,1,1,-1,0,0,3,-3
3709,2015-03-21,Man City,West Brom,3,0,H,2015-03-21,3,0,0,0,3,0,3,0,3
3710,2015-03-21,Newcastle,Arsenal,1,2,A,2015-03-21,1,2,5,5,-4,-3,0,3,-3
3711,2015-03-21,Southampton,Burnley,2,0,H,2015-03-21,3,0,1,1,2,-1,3,0,3
3712,2015-03-21,Stoke,Crystal Palace,1,2,A,2015-03-21,1,2,2,2,-1,0,0,3,-3
3713,2015-03-21,Tottenham,Leicester,4,3,H,2015-03-21,4,3,6,6,-2,-3,3,0,3
3714,2015-03-21,West Ham,Sunderland,1,0,H,2015-03-21,1,0,0,0,1,0,3,0,3
3715,2015-03-22,Hull,Chelsea,2,3,A,2015-03-28,2,3,3,3,-1,0,0,3,-3
3716,2015-03-22,Liverpool,Man United,1,2,A,2015-03-28,1,2,2,2,-1,0,0,3,-3
3717,2015-03-22,QPR,Everton,1,2,A,2015-03-28,1,2,2,2,-1,0,0,3,-3
3718,2015-04-04,Arsenal,Liverpool,4,1,H,2015-04-04,4,1,1,1,3,0,3,0,3
3719,2015-04-04,Chelsea,Stoke,2,1,H,2015-04-04,2,1,1,1,1,0,3,0,3
3720,2015-04-04,Everton,Southampton,1,0,H,2015-04-04,1,0,0,0,1,0,3,0,3
3721,2015-04-04,Leicester,West Ham,2,1,H,2015-04-04,2,1,1,1,1,0,3,0,3
3722,2015-04-04,Man United,Aston Villa,3,1,H,2015-04-04,3,1,1,1,2,0,3,0,3
3723,2015-04-04,Swansea,Hull,3,1,H,2015-04-04,3,1,1,1,2,0,3,0,3
3724,2015-04-04,West Brom,QPR,1,4,A,2015-04-04,1,4,4,4,-3,0,0,3,-3
3725,2015-04-05,Burnley,Tottenham,0,0,D,2015-04-11,0,0,1,1,-1,-1,1,1,0
3726,2015-04-05,Sunderland,Newcastle,1,0,H,2015-04-11,2,0,4,4,-2,-4,3,0,3
3727,2015-04-06,Crystal Palace,Man City,2,1,H,2015-04-11,6,1,2,2,4,-1,3,0,3
3728,2015-04-07,Aston Villa,QPR,3,3,D,2015-04-11,4,3,3,3,1,0,1,1,0
3729,2015-04-11,Burnley,Arsenal,0,1,A,2015-04-11,0,1,1,1,-1,0,1,3,-2
3730,2015-04-11,Southampton,Hull,2,0,H,2015-04-11,2,0,0,0,2,0,3,0,3
3731,2015-04-11,Sunderland,Crystal Palace,1,4,A,2015-04-11,2,6,4,4,-2,2,3,3,0
3732,2015-04-11,Swansea,Everton,1,1,D,2015-04-11,1,1,1,1,0,0,1,1,0
3733,2015-04-11,Tottenham,Aston Villa,0,1,A,2015-04-11,0,4,1,1,-1,3,0,3,-3
3734,2015-04-11,West Brom,Leicester,2,3,A,2015-04-11,2,3,3,3,-1,0,0,3,-3
3735,2015-04-11,West Ham,Stoke,1,1,D,2015-04-11,1,1,1,1,0,0,1,1,0
3736,2015-04-12,Man United,Man City,4,2,H,2015-04-18,4,2,3,3,1,-1,3,0,3
3737,2015-04-12,QPR,Chelsea,0,1,A,2015-04-18,0,2,1,1,-1,1,0,3,-3
3738,2015-04-13,Liverpool,Newcastle,2,0,H,2015-04-18,2,0,0,0,2,0,3,0,3
3739,2015-04-18,Chelsea,Man United,1,0,H,2015-04-18,2,4,0,0,2,4,3,0,3
3740,2015-04-18,Crystal Palace,West Brom,0,2,A,2015-04-18,0,2,2,2,-2,0,0,3,-3
3741,2015-04-18,Everton,Burnley,1,0,H,2015-04-18,1,0,0,0,1,0,3,0,3
3742,2015-04-18,Leicester,Swansea,2,0,H,2015-04-18,2,0,0,0,2,0,3,0,3
3743,2015-04-18,Stoke,Southampton,2,1,H,2015-04-18,2,1,1,1,1,0,3,0,3
3744,2015-04-19,Man City,West Ham,2,0,H,2015-04-25,5,0,2,2,3,-2,6,1,5
3745,2015-04-19,Newcastle,Tottenham,1,3,A,2015-04-25,3,5,6,6,-3,-1,0,4,-4
3746,2015-04-25,Burnley,Leicester,0,1,A,2015-04-25,0,1,1,1,-1,0,0,3,-3
3747,2015-04-25,Crystal Palace,Hull,0,2,A,2015-04-25,0,2,2,2,-2,0,0,3,-3
3748,2015-04-25,Man City,Aston Villa,3,2,H,2015-04-25,5,2,2,2,3,0,6,0,6
3749,2015-04-25,Newcastle,Swansea,2,3,A,2015-04-25,3,3,6,6,-3,-3,0,3,-3
3750,2015-04-25,QPR,West Ham,0,0,D,2015-04-25,0,0,0,0,0,0,1,1,0
3751,2015-04-25,Southampton,Tottenham,2,2,D,2015-04-25,2,5,2,2,0,3,1,4,-3
3752,2015-04-25,Stoke,Sunderland,1,1,D,2015-04-25,1,1,1,1,0,0,1,1,0
3753,2015-04-25,West Brom,Liverpool,0,0,D,2015-04-25,0,0,0,0,0,0,1,1,0
3754,2015-04-26,Arsenal,Chelsea,0,0,D,2015-05-02,0,3,0,0,0,3,1,4,-3
3755,2015-04-26,Everton,Man United,3,0,H,2015-05-02,5,0,3,3,2,-3,3,0,3
3756,2015-04-28,Hull,Liverpool,1,0,H,2015-05-02,1,2,0,0,1,2,3,0,3
3757,2015-04-29,Leicester,Chelsea,1,3,A,2015-05-02,4,3,3,3,1,0,3,4,-1
3758,2015-05-02,Aston Villa,Everton,3,2,H,2015-05-02,3,5,2,2,1,3,3,0,3
3759,2015-05-02,Leicester,Newcastle,3,0,H,2015-05-02,4,0,3,3,1,-3,3,0,3
3760,2015-05-02,Liverpool,QPR,2,1,H,2015-05-02,2,1,2,2,0,-1,3,0,3
3761,2015-05-02,Man United,West Brom,0,1,A,2015-05-02,0,1,4,4,-4,-3,0,3,-3
3762,2015-05-02,Sunderland,Southampton,2,1,H,2015-05-02,2,1,1,1,1,0,3,0,3
3763,2015-05-02,Swansea,Stoke,2,0,H,2015-05-02,2,0,0,0,2,0,3,0,3
3764,2015-05-02,West Ham,Burnley,1,0,H,2015-05-02,1,0,0,0,1,0,3,0,3
3765,2015-05-03,Chelsea,Crystal Palace,1,0,H,2015-05-09,1,1,0,0,1,1,3,0,3
3766,2015-05-03,Tottenham,Man City,0,1,A,2015-05-09,0,1,4,4,-4,-3,0,3,-3
3767,2015-05-09,Aston Villa,West Ham,1,0,H,2015-05-09,1,0,0,0,1,0,3,0,3
3768,2015-05-09,Crystal Palace,Man United,1,2,A,2015-05-09,1,2,3,3,-2,-1,0,3,-3
3769,2015-05-09,Everton,Sunderland,0,2,A,2015-05-09,0,2,2,2,-2,0,0,3,-3
3770,2015-05-09,Hull,Burnley,0,1,A,2015-05-09,0,1,1,1,-1,0,0,3,-3
3771,2015-05-09,Leicester,Southampton,2,0,H,2015-05-09,2,0,0,0,2,0,3,0,3
3772,2015-05-09,Newcastle,West Brom,1,1,D,2015-05-09,1,1,1,1,0,0,1,1,0
3773,2015-05-09,Stoke,Tottenham,3,0,H,2015-05-09,3,0,0,0,3,0,3,0,3
3774,2015-05-10,Chelsea,Liverpool,1,1,D,2015-05-16,1,2,1,1,0,1,1,1,0
3775,2015-05-10,Man City,QPR,6,0,H,2015-05-16,6,2,0,0,6,2,3,0,3
3776,2015-05-11,Arsenal,Swansea,0,1,A,2015-05-16,0,1,1,1,-1,0,0,3,-3
3777,2015-05-16,Burnley,Stoke,0,0,D,2015-05-16,0,0,0,0,0,0,1,1,0
3778,2015-05-16,Liverpool,Crystal Palace,1,3,A,2015-05-16,2,3,4,4,-2,-1,0,3,-3
3779,2015-05-16,QPR,Newcastle,2,1,H,2015-05-16,2,1,7,7,-5,-6,3,0,3
3780,2015-05-16,Southampton,Aston Villa,6,1,H,2015-05-16,6,1,1,1,5,0,3,0,3
3781,2015-05-16,Sunderland,Leicester,0,0,D,2015-05-16,0,0,0,0,0,0,1,1,0
3782,2015-05-16,Tottenham,Hull,2,0,H,2015-05-16,2,0,0,0,2,0,3,0,3
3783,2015-05-16,West Ham,Everton,1,2,A,2015-05-16,1,2,2,2,-1,0,0,3,-3
3784,2015-05-17,Man United,Arsenal,1,1,D,2015-05-23,1,1,1,1,0,0,1,1,0
3785,2015-05-17,Swansea,Man City,2,4,A,2015-05-23,2,4,4,4,-2,0,0,3,-3
3786,2015-05-18,West Brom,Chelsea,3,0,H,2015-05-23,3,0,0,0,3,0,3,0,3
3787,2015-05-20,Arsenal,Sunderland,0,0,D,2015-05-23,1,0,1,1,0,-1,1,1,0
3788,2015-05-24,Arsenal,West Brom,4,1,H,2015-05-30,4,1,1,1,3,0,3,0,3
3789,2015-05-24,Aston Villa,Burnley,0,1,A,2015-05-30,0,1,1,1,-1,0,0,3,-3
3790,2015-05-24,Chelsea,Sunderland,3,1,H,2015-05-30,3,1,1,1,2,0,3,0,3
3791,2015-05-24,Crystal Palace,Swansea,1,0,H,2015-05-30,1,0,0,0,1,0,3,0,3
3792,2015-05-24,Everton,Tottenham,0,1,A,2015-05-30,0,1,1,1,-1,0,0,3,-3
3793,2015-05-24,Hull,Man United,0,0,D,2015-05-30,0,0,0,0,0,0,1,1,0
3794,2015-05-24,Leicester,QPR,5,1,H,2015-05-30,5,1,1,1,4,0,3,0,3
3795,2015-05-24,Man City,Southampton,2,0,H,2015-05-30,2,0,0,0,2,0,3,0,3
3796,2015-05-24,Newcastle,West Ham,2,0,H,2015-05-30,2,0,0,0,2,0,3,0,3
3797,2015-05-24,Stoke,Liverpool,6,1,H,2015-05-30,6,1,1,1,5,0,3,0,3
3798,2015-08-08,Bournemouth,Aston Villa,0,1,A,2015-08-08,0,1,1,1,-1,0,0,3,-3
3799,2015-08-08,Chelsea,Swansea,2,2,D,2015-08-08,2,2,2,2,0,0,1,1,0
3800,2015-08-08,Everton,Watford,2,2,D,2015-08-08,2,2,2,2,0,0,1,1,0
3801,2015-08-08,Leicester,Sunderland,4,2,H,2015-08-08,4,2,2,2,2,0,3,0,3
3802,2015-08-08,Man United,Tottenham,1,0,H,2015-08-08,1,0,0,0,1,0,3,0,3
3803,2015-08-08,Norwich,Crystal Palace,1,3,A,2015-08-08,1,3,3,3,-2,0,0,3,-3
3804,2015-08-09,Arsenal,West Ham,0,2,A,2015-08-15,0,3,2,2,-2,1,0,3,-3
3805,2015-08-09,Newcastle,Southampton,2,2,D,2015-08-15,2,2,4,4,-2,-2,1,1,0
3806,2015-08-09,Stoke,Liverpool,0,1,A,2015-08-15,2,1,3,3,-1,-2,0,3,-3
3807,2015-08-10,West Brom,Man City,0,3,A,2015-08-15,0,3,3,3,-3,0,0,3,-3
3808,2015-08-14,Aston Villa,Man United,0,1,A,2015-08-15,0,1,1,1,-1,0,0,3,-3
3809,2015-08-15,Southampton,Everton,0,3,A,2015-08-15,2,3,5,5,-3,-2,0,3,-3
3810,2015-08-15,Sunderland,Norwich,1,3,A,2015-08-15,1,3,3,3,-2,0,0,3,-3
3811,2015-08-15,Swansea,Newcastle,2,0,H,2015-08-15,2,2,0,0,2,2,3,0,3
3812,2015-08-15,Tottenham,Stoke,2,2,D,2015-08-15,2,2,2,2,0,0,1,1,0
3813,2015-08-15,Watford,West Brom,0,0,D,2015-08-15,0,0,0,0,0,0,1,1,0
3814,2015-08-15,West Ham,Leicester,1,2,A,2015-08-15,3,2,2,2,1,0,0,3,-3
3815,2015-08-16,Crystal Palace,Arsenal,1,2,A,2015-08-22,3,2,3,3,0,-1,3,3,0
3816,2015-08-16,Man City,Chelsea,3,0,H,2015-08-22,3,0,0,0,3,0,3,0,3
3817,2015-08-17,Liverpool,Bournemouth,1,0,H,2015-08-22,1,4,0,0,1,4,3,3,0
3818,2015-08-22,Crystal Palace,Aston Villa,2,1,H,2015-08-22,3,1,3,3,0,-2,3,0,3
3819,2015-08-22,Leicester,Tottenham,1,1,D,2015-08-22,1,1,1,1,0,0,1,1,0
3820,2015-08-22,Man United,Newcastle,0,0,D,2015-08-22,0,0,0,0,0,0,1,1,0
3821,2015-08-22,Norwich,Stoke,1,1,D,2015-08-22,1,1,1,1,0,0,1,1,0
3822,2015-08-22,Sunderland,Swansea,1,1,D,2015-08-22,1,1,1,1,0,0,1,1,0
3823,2015-08-22,West Ham,Bournemouth,3,4,A,2015-08-22,3,4,4,4,-1,0,0,3,-3
3824,2015-08-23,Everton,Man City,0,2,A,2015-08-29,0,4,2,2,-2,2,0,3,-3
3825,2015-08-23,Watford,Southampton,0,0,D,2015-08-29,0,0,2,2,-2,-2,1,1,0
3826,2015-08-23,West Brom,Chelsea,2,3,A,2015-08-29,3,4,3,3,0,1,0,3,-3
3827,2015-08-24,Arsenal,Liverpool,0,0,D,2015-08-29,1,0,0,0,1,0,1,1,0
3828,2015-08-29,Aston Villa,Sunderland,2,2,D,2015-08-29,2,2,2,2,0,0,1,1,0
3829,2015-08-29,Bournemouth,Leicester,1,1,D,2015-08-29,1,1,1,1,0,0,1,1,0
3830,2015-08-29,Chelsea,Crystal Palace,1,2,A,2015-08-29,4,2,4,4,0,-2,0,3,-3
3831,2015-08-29,Liverpool,West Ham,0,3,A,2015-08-29,0,3,3,3,-3,0,0,3,-3
3832,2015-08-29,Man City,Watford,2,0,H,2015-08-29,4,0,0,0,4,0,3,0,3
3833,2015-08-29,Newcastle,Arsenal,0,1,A,2015-08-29,0,1,1,1,-1,0,0,3,-3
3834,2015-08-29,Stoke,West Brom,0,1,A,2015-08-29,0,3,1,1,-1,2,0,3,-3
3835,2015-08-29,Tottenham,Everton,0,0,D,2015-08-29,0,0,0,0,0,0,1,1,0
3836,2015-08-30,Southampton,Norwich,3,0,H,2015-09-05,3,0,0,0,3,0,3,0,3
3837,2015-08-30,Swansea,Man United,2,1,H,2015-09-05,2,1,1,1,1,0,3,0,3
3838,2015-09-12,Arsenal,Stoke,2,0,H,2015-09-12,2,0,0,0,2,0,3,0,3
3839,2015-09-12,Crystal Palace,Man City,0,1,A,2015-09-12,0,1,1,1,-1,0,0,3,-3
3840,2015-09-12,Everton,Chelsea,3,1,H,2015-09-12,3,1,1,1,2,0,3,0,3
3841,2015-09-12,Man United,Liverpool,3,1,H,2015-09-12,3,1,1,1,2,0,3,0,3
3842,2015-09-12,Norwich,Bournemouth,3,1,H,2015-09-12,3,1,1,1,2,0,3,0,3
3843,2015-09-12,Watford,Swansea,1,0,H,2015-09-12,1,0,0,0,1,0,3,0,3
3844,2015-09-12,West Brom,Southampton,0,0,D,2015-09-12,0,0,0,0,0,0,1,1,0
3845,2015-09-13,Leicester,Aston Villa,3,2,H,2015-09-19,5,2,4,4,1,-2,3,0,3
3846,2015-09-13,Sunderland,Tottenham,0,1,A,2015-09-19,0,1,3,3,-3,-2,0,3,-3
3847,2015-09-14,West Ham,Newcastle,2,0,H,2015-09-19,4,1,1,1,3,0,3,0,3
3848,2015-09-19,Aston Villa,West Brom,0,1,A,2015-09-19,2,1,4,4,-2,-3,0,3,-3
3849,2015-09-19,Bournemouth,Sunderland,2,0,H,2015-09-19,2,0,0,0,2,0,3,0,3
3850,2015-09-19,Chelsea,Arsenal,2,0,H,2015-09-19,2,0,0,0,2,0,3,0,3
3851,2015-09-19,Man City,West Ham,1,2,A,2015-09-19,1,4,2,2,-1,2,0,3,-3
3852,2015-09-19,Newcastle,Watford,1,2,A,2015-09-19,1,2,4,4,-3,-2,0,3,-3
3853,2015-09-19,Stoke,Leicester,2,2,D,2015-09-19,2,5,2,2,0,3,1,1,0
3854,2015-09-19,Swansea,Everton,0,0,D,2015-09-19,0,0,0,0,0,0,1,1,0
3855,2015-09-20,Liverpool,Norwich,1,1,D,2015-09-26,4,3,3,3,1,0,4,2,2
3856,2015-09-20,Southampton,Man United,2,3,A,2015-09-26,5,6,4,4,1,2,3,3,0
3857,2015-09-20,Tottenham,Crystal Palace,1,0,H,2015-09-26,5,0,1,1,4,-1,6,0,6
3858,2015-09-26,Leicester,Arsenal,2,5,A,2015-09-26,2,5,5,5,-3,0,0,3,-3
3859,2015-09-26,Liverpool,Aston Villa,3,2,H,2015-09-26,4,2,3,3,1,-1,4,0,4
3860,2015-09-26,Man United,Sunderland,3,0,H,2015-09-26,6,0,2,2,4,-2,3,0,3
3861,2015-09-26,Newcastle,Chelsea,2,2,D,2015-09-26,2,2,2,2,0,0,1,1,0
3862,2015-09-26,Southampton,Swansea,3,1,H,2015-09-26,5,1,4,4,1,-3,3,0,3
3863,2015-09-26,Stoke,Bournemouth,2,1,H,2015-09-26,2,1,1,1,1,0,3,0,3
3864,2015-09-26,Tottenham,Man City,4,1,H,2015-09-26,5,1,1,1,4,0,6,0,6
3865,2015-09-26,West Ham,Norwich,2,2,D,2015-09-26,2,3,2,2,0,1,1,2,-1
3866,2015-09-27,Watford,Crystal Palace,0,1,A,2015-10-03,1,3,2,2,-1,1,0,3,-3
3867,2015-09-28,West Brom,Everton,2,3,A,2015-10-03,2,3,5,5,-3,-2,0,3,-3
3868,2015-10-03,Aston Villa,Stoke,0,1,A,2015-10-03,0,1,1,1,-1,0,0,3,-3
3869,2015-10-03,Bournemouth,Watford,1,1,D,2015-10-03,1,1,1,1,0,0,1,1,0
3870,2015-10-03,Chelsea,Southampton,1,3,A,2015-10-03,1,3,3,3,-2,0,0,3,-3
3871,2015-10-03,Crystal Palace,West Brom,2,0,H,2015-10-03,3,2,0,0,3,2,3,0,3
3872,2015-10-03,Man City,Newcastle,6,1,H,2015-10-03,6,1,1,1,5,0,3,0,3
3873,2015-10-03,Norwich,Leicester,1,2,A,2015-10-03,1,2,2,2,-1,0,0,3,-3
3874,2015-10-03,Sunderland,West Ham,2,2,D,2015-10-03,2,2,2,2,0,0,1,1,0
3875,2015-10-04,Arsenal,Man United,3,0,H,2015-10-10,3,0,0,0,3,0,3,0,3
3876,2015-10-04,Everton,Liverpool,1,1,D,2015-10-10,1,1,1,1,0,0,1,1,0
3877,2015-10-04,Swansea,Tottenham,2,2,D,2015-10-10,2,2,2,2,0,0,1,1,0
3878,2015-10-17,Chelsea,Aston Villa,2,0,H,2015-10-17,2,0,0,0,2,0,3,0,3
3879,2015-10-17,Crystal Palace,West Ham,1,3,A,2015-10-17,1,3,3,3,-2,0,0,3,-3
3880,2015-10-17,Everton,Man United,0,3,A,2015-10-17,0,3,3,3,-3,0,0,3,-3
3881,2015-10-17,Man City,Bournemouth,5,1,H,2015-10-17,5,1,1,1,4,0,3,0,3
3882,2015-10-17,Southampton,Leicester,2,2,D,2015-10-17,2,2,2,2,0,0,1,1,0
3883,2015-10-17,Tottenham,Liverpool,0,0,D,2015-10-17,0,0,0,0,0,0,1,1,0
3884,2015-10-17,Watford,Arsenal,0,3,A,2015-10-17,0,3,3,3,-3,0,0,3,-3
3885,2015-10-17,West Brom,Sunderland,1,0,H,2015-10-17,1,0,0,0,1,0,3,0,3
3886,2015-10-18,Newcastle,Norwich,6,2,H,2015-10-24,6,2,2,2,4,0,3,0,3
3887,2015-10-19,Swansea,Stoke,0,1,A,2015-10-24,2,1,2,2,0,-1,0,3,-3
3888,2015-10-24,Arsenal,Everton,2,1,H,2015-10-24,2,1,1,1,1,0,3,0,3
3889,2015-10-24,Aston Villa,Swansea,1,2,A,2015-10-24,1,2,2,2,-1,0,0,3,-3
3890,2015-10-24,Leicester,Crystal Palace,1,0,H,2015-10-24,1,0,0,0,1,0,3,0,3
3891,2015-10-24,Norwich,West Brom,0,1,A,2015-10-24,2,1,7,7,-5,-6,0,3,-3
3892,2015-10-24,Stoke,Watford,0,2,A,2015-10-24,1,2,2,2,-1,0,0,3,-3
3893,2015-10-24,West Ham,Chelsea,2,1,H,2015-10-24,2,1,1,1,1,0,3,0,3
3894,2015-10-25,Bournemouth,Tottenham,1,5,A,2015-10-31,1,5,5,5,-4,0,0,3,-3
3895,2015-10-25,Liverpool,Southampton,1,1,D,2015-10-31,4,1,2,2,2,-1,1,1,0
3896,2015-10-25,Man United,Man City,0,0,D,2015-10-31,0,2,0,0,0,2,1,1,0
3897,2015-10-25,Sunderland,Newcastle,3,0,H,2015-10-31,3,0,0,0,3,0,3,0,3
3898,2015-10-31,Chelsea,Liverpool,1,3,A,2015-10-31,1,4,3,3,-2,1,0,3,-3
3899,2015-10-31,Crystal Palace,Man United,0,0,D,2015-10-31,0,0,0,0,0,0,1,1,0
3900,2015-10-31,Man City,Norwich,2,1,H,2015-10-31,2,1,1,1,1,0,3,0,3
3901,2015-10-31,Newcastle,Stoke,0,0,D,2015-10-31,0,0,3,3,-3,-3,1,1,0
3902,2015-10-31,Swansea,Arsenal,0,3,A,2015-10-31,0,3,3,3,-3,0,0,3,-3
3903,2015-10-31,Watford,West Ham,2,0,H,2015-10-31,2,0,0,0,2,0,3,0,3
3904,2015-10-31,West Brom,Leicester,2,3,A,2015-10-31,2,3,3,3,-1,0,0,3,-3
3905,2015-11-01,Everton,Sunderland,6,2,H,2015-11-07,7,2,3,3,4,-1,3,0,3
3906,2015-11-01,Southampton,Bournemouth,2,0,H,2015-11-07,3,0,0,0,3,0,3,0,3
3907,2015-11-02,Tottenham,Aston Villa,3,1,H,2015-11-07,3,1,1,1,2,0,3,0,3
3908,2015-11-07,Bournemouth,Newcastle,0,1,A,2015-11-07,0,1,3,3,-3,-2,0,3,-3
3909,2015-11-07,Leicester,Watford,2,1,H,2015-11-07,2,1,1,1,1,0,3,0,3
3910,2015-11-07,Man United,West Brom,2,0,H,2015-11-07,2,0,0,0,2,0,3,0,3
3911,2015-11-07,Norwich,Swansea,1,0,H,2015-11-07,1,0,0,0,1,0,3,0,3
3912,2015-11-07,Stoke,Chelsea,1,0,H,2015-11-07,1,0,0,0,1,0,3,0,3
3913,2015-11-07,Sunderland,Southampton,0,1,A,2015-11-07,2,3,7,7,-5,-4,0,3,-3
3914,2015-11-07,West Ham,Everton,1,1,D,2015-11-07,1,7,1,1,0,6,1,1,0
3915,2015-11-08,Arsenal,Tottenham,1,1,D,2015-11-14,1,1,1,1,0,0,1,1,0
3916,2015-11-08,Aston Villa,Man City,0,0,D,2015-11-14,0,0,0,0,0,0,1,1,0
3917,2015-11-08,Liverpool,Crystal Palace,1,2,A,2015-11-14,1,2,2,2,-1,0,0,3,-3
3918,2015-11-21,Chelsea,Norwich,1,0,H,2015-11-21,1,0,0,0,1,0,3,0,3
3919,2015-11-21,Everton,Aston Villa,4,0,H,2015-11-21,4,0,0,0,4,0,3,0,3
3920,2015-11-21,Man City,Liverpool,1,4,A,2015-11-21,1,4,4,4,-3,0,0,3,-3
3921,2015-11-21,Newcastle,Leicester,0,3,A,2015-11-21,0,3,3,3,-3,0,0,3,-3
3922,2015-11-21,Southampton,Stoke,0,1,A,2015-11-21,0,1,1,1,-1,0,0,3,-3
3923,2015-11-21,Swansea,Bournemouth,2,2,D,2015-11-21,2,2,2,2,0,0,1,1,0
3924,2015-11-21,Watford,Man United,1,2,A,2015-11-21,1,2,2,2,-1,0,0,3,-3
3925,2015-11-21,West Brom,Arsenal,2,1,H,2015-11-21,2,1,1,1,1,0,3,0,3
3926,2015-11-22,Tottenham,West Ham,4,1,H,2015-11-28,4,1,1,1,3,0,3,0,3
3927,2015-11-23,Crystal Palace,Sunderland,0,1,A,2015-11-28,5,3,2,2,3,1,3,3,0
3928,2015-11-28,Aston Villa,Watford,2,3,A,2015-11-28,2,3,3,3,-1,0,0,3,-3
3929,2015-11-28,Bournemouth,Everton,3,3,D,2015-11-28,3,3,3,3,0,0,1,1,0
3930,2015-11-28,Crystal Palace,Newcastle,5,1,H,2015-11-28,5,1,2,2,3,-1,3,0,3
3931,2015-11-28,Leicester,Man United,1,1,D,2015-11-28,1,1,1,1,0,0,1,1,0
3932,2015-11-28,Man City,Southampton,3,1,H,2015-11-28,3,1,1,1,2,0,3,0,3
3933,2015-11-28,Sunderland,Stoke,2,0,H,2015-11-28,3,0,0,0,3,0,3,0,3
3934,2015-11-29,Liverpool,Swansea,1,0,H,2015-12-05,1,0,0,0,1,0,3,0,3
3935,2015-11-29,Norwich,Arsenal,1,1,D,2015-12-05,1,4,3,3,-2,1,1,1,0
3936,2015-11-29,Tottenham,Chelsea,0,0,D,2015-12-05,1,0,1,1,0,-1,1,1,0
3937,2015-11-29,West Ham,West Brom,1,1,D,2015-12-05,1,2,1,1,0,1,1,1,0
3938,2015-12-05,Arsenal,Sunderland,3,1,H,2015-12-05,4,1,2,2,2,-1,3,0,3
3939,2015-12-05,Chelsea,Bournemouth,0,1,A,2015-12-05,0,1,1,1,-1,0,0,3,-3
3940,2015-12-05,Man United,West Ham,0,0,D,2015-12-05,0,1,0,0,0,1,1,1,0
3941,2015-12-05,Southampton,Aston Villa,1,1,D,2015-12-05,1,1,1,1,0,0,1,1,0
3942,2015-12-05,Stoke,Man City,2,0,H,2015-12-05,2,0,0,0,2,0,3,0,3
3943,2015-12-05,Swansea,Leicester,0,3,A,2015-12-05,0,3,4,4,-4,-1,0,3,-3
3944,2015-12-05,Watford,Norwich,2,0,H,2015-12-05,2,1,0,0,2,1,3,0,3
3945,2015-12-05,West Brom,Tottenham,1,1,D,2015-12-05,2,1,2,2,0,-1,1,1,0
3946,2015-12-06,Newcastle,Liverpool,2,0,H,2015-12-12,2,0,0,0,2,0,3,0,3
3947,2015-12-07,Everton,Crystal Palace,1,1,D,2015-12-12,2,2,2,2,0,0,1,1,0
3948,2015-12-12,Bournemouth,Man United,2,1,H,2015-12-12,2,1,1,1,1,0,3,0,3
3949,2015-12-12,Crystal Palace,Southampton,1,0,H,2015-12-12,2,0,1,1,1,-1,3,0,3
3950,2015-12-12,Man City,Swansea,2,1,H,2015-12-12,2,1,1,1,1,0,3,0,3
3951,2015-12-12,Norwich,Everton,1,1,D,2015-12-12,1,2,1,1,0,1,1,1,0
3952,2015-12-12,Sunderland,Watford,0,1,A,2015-12-12,0,1,1,1,-1,0,0,3,-3
3953,2015-12-12,West Ham,Stoke,0,0,D,2015-12-12,0,0,0,0,0,0,1,1,0
3954,2015-12-13,Aston Villa,Arsenal,0,2,A,2015-12-19,1,2,3,3,-2,-1,0,3,-3
3955,2015-12-13,Liverpool,West Brom,2,2,D,2015-12-19,2,3,2,2,0,1,1,1,0
3956,2015-12-14,Leicester,Chelsea,2,1,H,2015-12-19,5,4,3,3,2,1,3,0,3
3957,2015-12-19,Chelsea,Sunderland,3,1,H,2015-12-19,4,1,3,3,1,-2,3,0,3
3958,2015-12-19,Everton,Leicester,2,3,A,2015-12-19,2,5,3,3,-1,2,0,3,-3
3959,2015-12-19,Man United,Norwich,1,2,A,2015-12-19,1,2,2,2,-1,0,0,3,-3
3960,2015-12-19,Newcastle,Aston Villa,1,1,D,2015-12-19,1,1,1,1,0,0,1,1,0
3961,2015-12-19,Southampton,Tottenham,0,2,A,2015-12-19,0,2,2,2,-2,0,0,3,-3
3962,2015-12-19,Stoke,Crystal Palace,1,2,A,2015-12-19,1,2,2,2,-1,0,0,3,-3
3963,2015-12-19,West Brom,Bournemouth,1,2,A,2015-12-19,3,2,4,4,-1,-2,0,3,-3
3964,2015-12-20,Swansea,West Ham,0,0,D,2015-12-26,1,1,0,0,1,1,4,2,2
3965,2015-12-20,Watford,Liverpool,3,0,H,2015-12-26,5,1,2,2,3,-1,3,0,3
3966,2015-12-21,Arsenal,Man City,2,1,H,2015-12-26,2,5,5,5,-3,0,3,0,3
3967,2015-12-26,Aston Villa,West Ham,1,1,D,2015-12-26,1,1,1,1,0,0,1,2,-1
3968,2015-12-26,Bournemouth,Crystal Palace,0,0,D,2015-12-26,0,0,0,0,0,0,1,1,0
3969,2015-12-26,Chelsea,Watford,2,2,D,2015-12-26,2,5,2,2,0,3,1,1,0
3970,2015-12-26,Liverpool,Leicester,1,0,H,2015-12-26,1,0,3,3,-2,-3,3,0,3
3971,2015-12-26,Man City,Sunderland,4,1,H,2015-12-26,5,1,3,3,2,-2,3,0,3
3972,2015-12-26,Newcastle,Everton,0,1,A,2015-12-26,0,1,1,1,-1,0,0,3,-3
3973,2015-12-26,Southampton,Arsenal,4,0,H,2015-12-26,4,2,0,0,4,2,3,0,3
3974,2015-12-26,Stoke,Man United,2,0,H,2015-12-26,2,0,0,0,2,0,3,0,3
3975,2015-12-26,Swansea,West Brom,1,0,H,2015-12-26,1,0,0,0,1,0,4,0,4
3976,2015-12-26,Tottenham,Norwich,3,0,H,2015-12-26,3,0,0,0,3,0,3,0,3
3977,2015-12-28,Arsenal,Bournemouth,2,0,H,2016-01-02,3,0,0,0,3,0,6,1,5
3978,2015-12-28,Crystal Palace,Swansea,0,0,D,2016-01-02,0,1,0,0,0,1,1,1,0
3979,2015-12-28,Everton,Stoke,3,4,A,2016-01-02,3,5,4,4,-1,1,0,3,-3
3980,2015-12-28,Man United,Chelsea,0,0,D,2016-01-02,2,0,1,1,1,-1,4,1,3
3981,2015-12-28,Norwich,Aston Villa,2,0,H,2016-01-02,3,1,0,0,3,1,6,0,6
3982,2015-12-28,Watford,Tottenham,1,2,A,2016-01-02,2,2,4,4,-2,-2,0,3,-3
3983,2015-12-28,West Brom,Newcastle,1,0,H,2016-01-02,3,0,1,1,2,-1,6,0,6
3984,2015-12-28,West Ham,Southampton,2,1,H,2016-01-02,4,1,1,1,3,0,6,0,6
3985,2015-12-29,Leicester,Man City,0,0,D,2016-01-02,0,2,0,0,0,2,2,4,-2
3986,2015-12-30,Sunderland,Liverpool,0,1,A,2016-01-02,3,1,2,2,1,-1,3,3,0
3987,2016-01-02,Arsenal,Newcastle,1,0,H,2016-01-02,3,0,0,0,3,0,6,0,6
3988,2016-01-02,Leicester,Bournemouth,0,0,D,2016-01-02,0,0,0,0,0,0,2,1,1
3989,2016-01-02,Man United,Swansea,2,1,H,2016-01-02,2,1,1,1,1,0,4,1,3
3990,2016-01-02,Norwich,Southampton,1,0,H,2016-01-02,3,1,0,0,3,1,6,0,6
3991,2016-01-02,Sunderland,Aston Villa,3,1,H,2016-01-02,3,1,2,2,1,-1,3,0,3
3992,2016-01-02,Watford,Man City,1,2,A,2016-01-02,2,2,4,4,-2,-2,0,4,-4
3993,2016-01-02,West Brom,Stoke,2,1,H,2016-01-02,3,5,1,1,2,4,6,3,3
3994,2016-01-02,West Ham,Liverpool,2,0,H,2016-01-02,4,1,1,1,3,0,6,3,3
3995,2016-01-03,Crystal Palace,Chelsea,0,3,A,2016-01-09,0,3,3,3,-3,0,0,3,-3
3996,2016-01-03,Everton,Tottenham,1,1,D,2016-01-09,1,1,1,1,0,0,1,1,0
3997,2016-01-12,Aston Villa,Crystal Palace,1,0,H,2016-01-16,2,0,1,1,1,-1,4,0,4
3998,2016-01-12,Bournemouth,West Ham,1,3,A,2016-01-16,4,4,3,3,1,1,3,3,0
3999,2016-01-12,Newcastle,Man United,3,3,D,2016-01-16,5,3,4,4,1,-1,4,1,3
4000,2016-01-13,Chelsea,West Brom,2,2,D,2016-01-16,5,2,5,5,0,-3,2,1,1
4001,2016-01-13,Liverpool,Arsenal,3,3,D,2016-01-16,3,3,3,3,0,0,1,1,0
4002,2016-01-13,Man City,Everton,0,0,D,2016-01-16,4,3,0,0,4,3,4,2,2
4003,2016-01-13,Southampton,Watford,2,0,H,2016-01-16,5,0,0,0,5,0,6,0,6
4004,2016-01-13,Stoke,Norwich,3,1,H,2016-01-16,3,1,1,1,2,0,3,0,3
4005,2016-01-13,Swansea,Sunderland,2,4,A,2016-01-16,2,5,4,4,-2,1,0,3,-3
4006,2016-01-13,Tottenham,Leicester,0,1,A,2016-01-16,4,2,2,2,2,0,3,4,-1
4007,2016-01-16,Aston Villa,Leicester,1,1,D,2016-01-16,2,2,1,1,1,1,4,4,0
4008,2016-01-16,Bournemouth,Norwich,3,0,H,2016-01-16,4,1,3,3,1,-2,3,0,3
4009,2016-01-16,Chelsea,Everton,3,3,D,2016-01-16,5,3,5,5,0,-2,2,2,0
4010,2016-01-16,Man City,Crystal Palace,4,0,H,2016-01-16,4,0,0,0,4,0,4,0,4
4011,2016-01-16,Newcastle,West Ham,2,1,H,2016-01-16,5,4,4,4,1,0,4,3,1
4012,2016-01-16,Southampton,West Brom,3,0,H,2016-01-16,5,2,0,0,5,2,6,1,5
4013,2016-01-16,Tottenham,Sunderland,4,1,H,2016-01-16,4,5,2,2,2,3,3,3,0
4014,2016-01-17,Liverpool,Man United,0,1,A,2016-01-23,5,1,5,5,0,-4,0,3,-3
4015,2016-01-17,Stoke,Arsenal,0,0,D,2016-01-23,0,0,3,3,-3,-3,1,1,0
4016,2016-01-18,Swansea,Watford,1,0,H,2016-01-23,1,2,0,0,1,2,3,0,3
4017,2016-01-23,Crystal Palace,Tottenham,1,3,A,2016-01-23,1,3,3,3,-2,0,0,3,-3
4018,2016-01-23,Leicester,Stoke,3,0,H,2016-01-23,3,0,0,0,3,0,3,0,3
4019,2016-01-23,Man United,Southampton,0,1,A,2016-01-23,1,1,1,1,0,0,0,3,-3
4020,2016-01-23,Norwich,Liverpool,4,5,A,2016-01-23,4,5,5,5,-1,0,0,3,-3
4021,2016-01-23,Sunderland,Bournemouth,1,1,D,2016-01-23,1,1,1,1,0,0,1,1,0
4022,2016-01-23,Watford,Newcastle,2,1,H,2016-01-23,2,1,2,2,0,-1,3,0,3
4023,2016-01-23,West Brom,Aston Villa,0,0,D,2016-01-23,0,0,0,0,0,0,1,1,0
4024,2016-01-23,West Ham,Man City,2,2,D,2016-01-23,2,2,2,2,0,0,1,1,0
4025,2016-01-24,Arsenal,Chelsea,0,1,A,2016-01-30,0,1,1,1,-1,0,0,3,-3
4026,2016-01-24,Everton,Swansea,1,2,A,2016-01-30,1,2,2,2,-1,0,0,3,-3
4027,2016-02-02,Arsenal,Southampton,0,0,D,2016-02-06,0,1,0,0,0,1,1,1,0
4028,2016-02-02,Crystal Palace,Bournemouth,1,2,A,2016-02-06,2,2,3,3,-1,-1,0,3,-3
4029,2016-02-02,Leicester,Liverpool,2,0,H,2016-02-06,5,2,1,1,4,1,3,0,3
4030,2016-02-02,Man United,Stoke,3,0,H,2016-02-06,3,0,0,0,3,0,3,0,3
4031,2016-02-02,Norwich,Tottenham,0,3,A,2016-02-06,0,4,5,5,-5,-1,0,3,-3
4032,2016-02-02,Sunderland,Man City,0,1,A,2016-02-06,2,2,3,3,-1,-1,0,3,-3
4033,2016-02-02,West Brom,Swansea,1,1,D,2016-02-06,1,2,2,2,-1,0,1,1,0
4034,2016-02-02,West Ham,Aston Villa,2,0,H,2016-02-06,2,2,1,1,1,1,3,0,3
4035,2016-02-03,Everton,Newcastle,3,0,H,2016-02-06,6,1,0,0,6,1,3,0,3
4036,2016-02-03,Watford,Chelsea,0,0,D,2016-02-06,0,0,1,1,-1,-1,1,1,0
4037,2016-02-06,Aston Villa,Norwich,2,0,H,2016-02-06,2,0,2,2,0,-2,3,0,3
4038,2016-02-06,Liverpool,Sunderland,2,2,D,2016-02-06,2,2,4,4,-2,-2,1,1,0
4039,2016-02-06,Man City,Leicester,1,3,A,2016-02-06,2,5,3,3,-1,2,0,3,-3
4040,2016-02-06,Newcastle,West Brom,1,0,H,2016-02-06,1,1,3,3,-2,-2,3,0,3
4041,2016-02-06,Southampton,West Ham,1,0,H,2016-02-06,1,2,0,0,1,2,3,0,3
4042,2016-02-06,Stoke,Everton,0,3,A,2016-02-06,0,6,6,6,-6,0,0,3,-3
4043,2016-02-06,Swansea,Crystal Palace,1,1,D,2016-02-06,2,2,2,2,0,0,1,1,0
4044,2016-02-06,Tottenham,Watford,1,0,H,2016-02-06,4,0,0,0,4,0,3,0,3
4045,2016-02-07,Bournemouth,Arsenal,0,2,A,2016-02-13,1,2,5,5,-4,-3,0,3,-3
4046,2016-02-07,Chelsea,Man United,1,1,D,2016-02-13,6,2,2,2,4,0,4,1,3
4047,2016-02-13,Bournemouth,Stoke,1,3,A,2016-02-13,1,3,5,5,-4,-2,0,3,-3
4048,2016-02-13,Chelsea,Newcastle,5,1,H,2016-02-13,6,1,2,2,4,-1,4,0,4
4049,2016-02-13,Crystal Palace,Watford,1,2,A,2016-02-13,1,2,2,2,-1,0,0,3,-3
4050,2016-02-13,Everton,West Brom,0,1,A,2016-02-13,0,1,1,1,-1,0,0,3,-3
4051,2016-02-13,Norwich,West Ham,2,2,D,2016-02-13,2,2,2,2,0,0,1,1,0
4052,2016-02-13,Sunderland,Man United,2,1,H,2016-02-13,2,2,1,1,1,1,3,1,2
4053,2016-02-13,Swansea,Southampton,0,1,A,2016-02-13,0,1,1,1,-1,0,0,3,-3
4054,2016-02-14,Arsenal,Leicester,2,1,H,2016-02-20,2,1,1,1,1,0,3,0,3
4055,2016-02-14,Aston Villa,Liverpool,0,6,A,2016-02-20,0,6,6,6,-6,0,0,3,-3
4056,2016-02-14,Man City,Tottenham,1,2,A,2016-02-20,1,2,2,2,-1,0,0,3,-3
4057,2016-02-27,Leicester,Norwich,1,0,H,2016-02-27,1,0,0,0,1,0,3,0,3
4058,2016-02-27,Southampton,Chelsea,1,2,A,2016-02-27,1,2,2,2,-1,0,0,3,-3
4059,2016-02-27,Stoke,Aston Villa,2,1,H,2016-02-27,2,1,1,1,1,0,3,0,3
4060,2016-02-27,Watford,Bournemouth,0,0,D,2016-02-27,0,0,0,0,0,0,1,1,0
4061,2016-02-27,West Brom,Crystal Palace,3,2,H,2016-02-27,3,2,2,2,1,0,3,0,3
4062,2016-02-27,West Ham,Sunderland,1,0,H,2016-02-27,1,0,0,0,1,0,3,0,3
4063,2016-02-28,Tottenham,Swansea,2,1,H,2016-03-05,4,4,4,4,0,0,4,3,1
4064,2016-02-28,Man United,Arsenal,3,2,H,2016-03-05,4,5,2,2,2,3,6,1,5
4065,2016-03-01,Aston Villa,Everton,1,3,A,2016-03-05,1,5,7,7,-6,-2,0,3,-3
4066,2016-03-01,Bournemouth,Southampton,2,0,H,2016-03-05,5,1,1,1,4,0,3,0,3
4067,2016-03-01,Leicester,West Brom,2,2,D,2016-03-05,3,2,2,2,1,0,1,1,0
4068,2016-03-01,Norwich,Chelsea,1,2,A,2016-03-05,1,3,3,3,-2,0,0,3,-3
4069,2016-03-01,Sunderland,Crystal Palace,2,2,D,2016-03-05,3,2,3,3,0,-1,1,1,0
4070,2016-03-02,Arsenal,Swansea,1,2,A,2016-03-05,5,4,7,7,-2,-3,0,3,-3
4071,2016-03-02,Liverpool,Man City,3,0,H,2016-03-05,3,4,0,0,3,4,3,0,3
4072,2016-03-02,Man United,Watford,1,0,H,2016-03-05,4,0,2,2,2,-2,6,0,6
4073,2016-03-02,Stoke,Newcastle,1,0,H,2016-03-05,2,1,1,1,1,0,3,0,3
4074,2016-03-02,West Ham,Tottenham,1,0,H,2016-03-05,4,4,2,2,2,2,3,0,3
4075,2016-03-05,Chelsea,Stoke,1,1,D,2016-03-05,3,2,2,2,1,0,1,1,0
4076,2016-03-05,Everton,West Ham,2,3,A,2016-03-05,5,4,4,4,1,0,0,3,-3
4077,2016-03-05,Man City,Aston Villa,4,0,H,2016-03-05,4,1,3,3,1,-2,3,0,3
4078,2016-03-05,Newcastle,Bournemouth,1,3,A,2016-03-05,1,5,4,4,-3,1,0,3,-3
4079,2016-03-05,Southampton,Sunderland,1,1,D,2016-03-05,1,3,3,3,-2,0,1,1,0
4080,2016-03-05,Swansea,Norwich,1,0,H,2016-03-05,4,1,3,3,1,-2,3,0,3
4081,2016-03-05,Tottenham,Arsenal,2,2,D,2016-03-05,4,5,4,4,0,1,4,1,3
4082,2016-03-05,Watford,Leicester,0,1,A,2016-03-05,0,3,2,2,-2,1,0,3,-3
4083,2016-03-06,Crystal Palace,Liverpool,1,2,A,2016-03-12,1,2,2,2,-1,0,0,3,-3
4084,2016-03-06,West Brom,Man United,1,0,H,2016-03-12,1,0,0,0,1,0,3,0,3
4085,2016-03-12,Bournemouth,Swansea,3,2,H,2016-03-12,3,2,2,2,1,0,3,0,3
4086,2016-03-12,Norwich,Man City,0,0,D,2016-03-12,0,0,0,0,0,0,1,1,0
4087,2016-03-12,Stoke,Southampton,1,2,A,2016-03-12,1,2,2,2,-1,0,0,3,-3
4088,2016-03-13,Aston Villa,Tottenham,0,2,A,2016-03-19,0,2,3,3,-3,-1,0,3,-3
4089,2016-03-14,Leicester,Newcastle,1,0,H,2016-03-19,2,0,0,0,2,0,3,0,3
4090,2016-03-19,Chelsea,West Ham,2,2,D,2016-03-19,2,2,2,2,0,0,1,1,0
4091,2016-03-19,Crystal Palace,Leicester,0,1,A,2016-03-19,0,2,1,1,-1,1,0,3,-3
4092,2016-03-19,Everton,Arsenal,0,2,A,2016-03-19,0,2,2,2,-2,0,0,3,-3
4093,2016-03-19,Swansea,Aston Villa,1,0,H,2016-03-19,1,0,0,0,1,0,3,0,3
4094,2016-03-19,Watford,Stoke,1,2,A,2016-03-19,1,2,2,2,-1,0,0,3,-3
4095,2016-03-19,West Brom,Norwich,0,1,A,2016-03-19,0,1,1,1,-1,0,0,3,-3
4096,2016-03-20,Man City,Man United,0,1,A,2016-03-26,0,1,1,1,-1,0,0,3,-3
4097,2016-03-20,Newcastle,Sunderland,1,1,D,2016-03-26,1,1,1,1,0,0,1,1,0
4098,2016-03-20,Southampton,Liverpool,3,2,H,2016-03-26,3,2,2,2,1,0,3,0,3
4099,2016-03-20,Tottenham,Bournemouth,3,0,H,2016-03-26,3,0,0,0,3,0,3,0,3
4100,2016-04-02,Arsenal,Watford,4,0,H,2016-04-02,4,0,0,0,4,0,3,0,3
4101,2016-04-02,Aston Villa,Chelsea,0,4,A,2016-04-02,0,4,4,4,-4,0,0,3,-3
4102,2016-04-02,Bournemouth,Man City,0,4,A,2016-04-02,0,4,4,4,-4,0,0,3,-3
4103,2016-04-02,Liverpool,Tottenham,1,1,D,2016-04-02,1,1,1,1,0,0,1,1,0
4104,2016-04-02,Norwich,Newcastle,3,2,H,2016-04-02,3,2,2,2,1,0,3,0,3
4105,2016-04-02,Stoke,Swansea,2,2,D,2016-04-02,2,2,2,2,0,0,1,1,0
4106,2016-04-02,Sunderland,West Brom,0,0,D,2016-04-02,0,0,0,0,0,0,1,1,0
4107,2016-04-02,West Ham,Crystal Palace,2,2,D,2016-04-02,2,2,2,2,0,0,1,1,0
4108,2016-04-03,Leicester,Southampton,1,0,H,2016-04-09,1,3,0,0,1,3,3,0,3
4109,2016-04-03,Man United,Everton,1,0,H,2016-04-09,1,1,0,0,1,1,3,1,2
4110,2016-04-09,Aston Villa,Bournemouth,1,2,A,2016-04-09,1,2,2,2,-1,0,0,3,-3
4111,2016-04-09,Crystal Palace,Norwich,1,0,H,2016-04-09,1,0,0,0,1,0,3,0,3
4112,2016-04-09,Man City,West Brom,2,1,H,2016-04-09,2,1,1,1,1,0,3,0,3
4113,2016-04-09,Southampton,Newcastle,3,1,H,2016-04-09,3,1,2,2,1,-1,3,0,3
4114,2016-04-09,Swansea,Chelsea,1,0,H,2016-04-09,1,0,0,0,1,0,3,0,3
4115,2016-04-09,Watford,Everton,1,1,D,2016-04-09,1,1,1,1,0,0,1,1,0
4116,2016-04-09,West Ham,Arsenal,3,3,D,2016-04-09,3,3,3,3,0,0,1,1,0
4117,2016-04-10,Liverpool,Stoke,4,1,H,2016-04-16,4,1,1,1,3,0,3,0,3
4118,2016-04-10,Sunderland,Leicester,0,2,A,2016-04-16,3,2,2,2,1,0,0,3,-3
4119,2016-04-10,Tottenham,Man United,3,0,H,2016-04-16,3,1,0,0,3,1,3,0,3
4120,2016-04-13,Crystal Palace,Everton,0,0,D,2016-04-16,0,1,0,0,0,1,1,1,0
4121,2016-04-16,Chelsea,Man City,0,3,A,2016-04-16,0,3,3,3,-3,0,0,3,-3
4122,2016-04-16,Everton,Southampton,1,1,D,2016-04-16,1,1,1,1,0,0,1,1,0
4123,2016-04-16,Man United,Aston Villa,1,0,H,2016-04-16,1,0,3,3,-2,-3,3,0,3
4124,2016-04-16,Newcastle,Swansea,3,0,H,2016-04-16,3,0,0,0,3,0,3,0,3
4125,2016-04-16,Norwich,Sunderland,0,3,A,2016-04-16,0,3,3,3,-3,0,0,3,-3
4126,2016-04-16,West Brom,Watford,0,1,A,2016-04-16,0,1,1,1,-1,0,0,3,-3
4127,2016-04-17,Arsenal,Crystal Palace,1,1,D,2016-04-23,3,1,1,1,2,0,4,1,3
4128,2016-04-17,Bournemouth,Liverpool,1,2,A,2016-04-23,2,8,6,6,-4,2,0,3,-3
4129,2016-04-17,Leicester,West Ham,2,2,D,2016-04-23,2,5,2,2,0,3,1,1,0
4130,2016-04-18,Stoke,Tottenham,0,4,A,2016-04-23,0,4,8,8,-8,-4,0,3,-3
4131,2016-04-19,Newcastle,Man City,1,1,D,2016-04-23,3,5,3,3,0,2,1,1,0
4132,2016-04-20,Liverpool,Everton,4,0,H,2016-04-23,8,0,3,3,5,-3,4,0,4
4133,2016-04-20,Man United,Crystal Palace,2,0,H,2016-04-23,2,1,0,0,2,1,3,1,2
4134,2016-04-20,West Ham,Watford,3,1,H,2016-04-23,5,1,3,3,2,-2,3,0,3
4135,2016-04-21,Arsenal,West Brom,2,0,H,2016-04-23,3,0,1,1,2,-1,4,0,4
4136,2016-04-23,Aston Villa,Southampton,2,4,A,2016-04-23,2,4,4,4,-2,0,0,3,-3
4137,2016-04-23,Bournemouth,Chelsea,1,4,A,2016-04-23,2,4,6,6,-4,-2,0,3,-3
4138,2016-04-23,Liverpool,Newcastle,2,2,D,2016-04-23,8,3,3,3,5,0,4,1,3
4139,2016-04-23,Man City,Stoke,4,0,H,2016-04-23,5,0,1,1,4,-1,3,0,3
4140,2016-04-24,Leicester,Swansea,4,0,H,2016-04-30,4,0,0,0,4,0,3,0,3
4141,2016-04-24,Sunderland,Arsenal,0,0,D,2016-04-30,1,1,1,1,0,0,1,1,0
4142,2016-04-25,Tottenham,West Brom,1,1,D,2016-04-30,1,1,1,1,0,0,1,1,0
4143,2016-04-30,Arsenal,Norwich,1,0,H,2016-04-30,1,0,0,0,1,0,3,0,3
4144,2016-04-30,Everton,Bournemouth,2,1,H,2016-04-30,2,1,1,1,1,0,3,0,3
4145,2016-04-30,Newcastle,Crystal Palace,1,0,H,2016-04-30,1,0,0,0,1,0,3,0,3
4146,2016-04-30,Stoke,Sunderland,1,1,D,2016-04-30,1,1,1,1,0,0,1,1,0
4147,2016-04-30,Watford,Aston Villa,3,2,H,2016-04-30,3,2,2,2,1,0,3,0,3
4148,2016-04-30,West Brom,West Ham,0,3,A,2016-04-30,1,3,4,4,-3,-1,0,3,-3
4149,2016-05-01,Man United,Leicester,1,1,D,2016-05-07,2,4,1,1,1,3,1,1,0
4150,2016-05-01,Southampton,Man City,4,2,H,2016-05-07,4,2,2,2,2,0,3,0,3
4151,2016-05-01,Swansea,Liverpool,3,1,H,2016-05-07,7,1,2,2,5,-1,3,0,3
4152,2016-05-02,Chelsea,Tottenham,2,2,D,2016-05-07,4,2,5,5,-1,-3,1,1,0
4153,2016-05-07,Aston Villa,Newcastle,0,0,D,2016-05-07,0,0,0,0,0,0,1,1,0
4154,2016-05-07,Bournemouth,West Brom,1,1,D,2016-05-07,1,1,1,1,0,0,1,1,0
4155,2016-05-07,Crystal Palace,Stoke,2,1,H,2016-05-07,2,1,1,1,1,0,3,0,3
4156,2016-05-07,Leicester,Everton,3,1,H,2016-05-07,4,1,2,2,2,-1,3,0,3
4157,2016-05-07,Norwich,Man United,0,1,A,2016-05-07,0,2,1,1,-1,1,0,3,-3
4158,2016-05-07,Sunderland,Chelsea,3,2,H,2016-05-07,3,4,2,2,1,2,3,0,3
4159,2016-05-07,West Ham,Swansea,1,4,A,2016-05-07,1,7,4,4,-3,3,0,3,-3
4160,2016-05-08,Liverpool,Watford,2,0,H,2016-05-14,3,2,1,1,2,1,4,0,4
4161,2016-05-08,Man City,Arsenal,2,2,D,2016-05-14,2,2,2,2,0,0,1,1,0
4162,2016-05-08,Tottenham,Southampton,1,2,A,2016-05-14,1,2,2,2,-1,0,0,3,-3
4163,2016-05-10,West Ham,Man United,3,2,H,2016-05-14,3,2,2,2,1,0,3,0,3
4164,2016-05-11,Liverpool,Chelsea,1,1,D,2016-05-14,3,1,1,1,2,0,4,1,3
4165,2016-05-11,Norwich,Watford,4,2,H,2016-05-14,4,2,2,2,2,0,3,0,3
4166,2016-05-11,Sunderland,Everton,3,0,H,2016-05-14,3,0,0,0,3,0,3,0,3
4167,2016-05-15,Arsenal,Aston Villa,4,0,H,2016-05-21,4,0,0,0,4,0,3,0,3
4168,2016-05-15,Chelsea,Leicester,1,1,D,2016-05-21,1,1,1,1,0,0,1,1,0
4169,2016-05-15,Everton,Norwich,3,0,H,2016-05-21,3,0,0,0,3,0,3,0,3
4170,2016-05-15,Newcastle,Tottenham,5,1,H,2016-05-21,5,1,1,1,4,0,3,0,3
4171,2016-05-15,Southampton,Crystal Palace,4,1,H,2016-05-21,4,1,1,1,3,0,3,0,3
4172,2016-05-15,Stoke,West Ham,2,1,H,2016-05-21,2,1,1,1,1,0,3,0,3
4173,2016-05-15,Swansea,Man City,1,1,D,2016-05-21,1,1,1,1,0,0,1,1,0
4174,2016-05-15,Watford,Sunderland,2,2,D,2016-05-21,2,2,2,2,0,0,1,1,0
4175,2016-05-15,West Brom,Liverpool,1,1,D,2016-05-21,1,1,1,1,0,0,1,1,0
4176,2016-05-17,Man United,Bournemouth,3,1,H,2016-05-21,3,1,1,1,2,0,3,0,3
4177,2016-08-13,Burnley,Swansea,0,1,A,2016-08-13,0,1,1,1,-1,0,0,3,-3
4178,2016-08-13,Crystal Palace,West Brom,0,1,A,2016-08-13,0,1,1,1,-1,0,0,3,-3
4179,2016-08-13,Everton,Tottenham,1,1,D,2016-08-13,1,1,1,1,0,0,1,1,0
4180,2016-08-13,Hull,Leicester,2,1,H,2016-08-13,2,1,1,1,1,0,3,0,3
4181,2016-08-13,Man City,Sunderland,2,1,H,2016-08-13,2,1,1,1,1,0,3,0,3
4182,2016-08-13,Middlesbrough,Stoke,1,1,D,2016-08-13,1,1,1,1,0,0,1,1,0
4183,2016-08-13,Southampton,Watford,1,1,D,2016-08-13,1,1,1,1,0,0,1,1,0
4184,2016-08-14,Arsenal,Liverpool,3,4,A,2016-08-20,3,4,4,4,-1,0,0,3,-3
4185,2016-08-14,Bournemouth,Man United,1,3,A,2016-08-20,1,5,3,3,-2,2,0,3,-3
4186,2016-08-15,Chelsea,West Ham,2,1,H,2016-08-20,4,1,2,2,2,-1,3,0,3
4187,2016-08-19,Man United,Southampton,2,0,H,2016-08-20,5,0,1,1,4,-1,3,0,3
4188,2016-08-20,Burnley,Liverpool,2,0,H,2016-08-20,2,4,0,0,2,4,3,3,0
4189,2016-08-20,Leicester,Arsenal,0,0,D,2016-08-20,0,3,0,0,0,3,1,1,0
4190,2016-08-20,Stoke,Man City,1,4,A,2016-08-20,1,4,4,4,-3,0,0,3,-3
4191,2016-08-20,Swansea,Hull,0,2,A,2016-08-20,0,2,2,2,-2,0,0,3,-3
4192,2016-08-20,Tottenham,Crystal Palace,1,0,H,2016-08-20,1,0,0,0,1,0,3,0,3
4193,2016-08-20,Watford,Chelsea,1,2,A,2016-08-20,1,4,2,2,-1,2,0,3,-3
4194,2016-08-20,West Brom,Everton,1,2,A,2016-08-20,1,2,2,2,-1,0,0,3,-3
4195,2016-08-21,Sunderland,Middlesbrough,1,2,A,2016-08-27,2,2,3,3,-1,-1,0,3,-3
4196,2016-08-21,West Ham,Bournemouth,1,0,H,2016-08-27,1,1,0,0,1,1,3,1,2
4197,2016-08-27,Chelsea,Burnley,3,0,H,2016-08-27,3,0,0,0,3,0,3,0,3
4198,2016-08-27,Crystal Palace,Bournemouth,1,1,D,2016-08-27,1,1,1,1,0,0,1,1,0
4199,2016-08-27,Everton,Stoke,1,0,H,2016-08-27,1,0,0,0,1,0,3,0,3
4200,2016-08-27,Hull,Man United,0,1,A,2016-08-27,0,1,1,1,-1,0,0,3,-3
4201,2016-08-27,Leicester,Swansea,2,1,H,2016-08-27,2,1,1,1,1,0,3,0,3
4202,2016-08-27,Southampton,Sunderland,1,1,D,2016-08-27,1,2,1,1,0,1,1,1,0
4203,2016-08-27,Tottenham,Liverpool,1,1,D,2016-08-27,1,1,1,1,0,0,1,1,0
4204,2016-08-27,Watford,Arsenal,1,3,A,2016-08-27,1,3,3,3,-2,0,0,3,-3
4205,2016-08-28,Man City,West Ham,3,1,H,2016-09-03,3,1,1,1,2,0,3,0,3
4206,2016-08-28,West Brom,Middlesbrough,0,0,D,2016-09-03,0,0,0,0,0,0,1,1,0
4207,2016-09-10,Arsenal,Southampton,2,1,H,2016-09-10,2,1,1,1,1,0,3,0,3
4208,2016-09-10,Bournemouth,West Brom,1,0,H,2016-09-10,1,0,0,0,1,0,3,0,3
4209,2016-09-10,Burnley,Hull,1,1,D,2016-09-10,1,1,1,1,0,0,1,1,0
4210,2016-09-10,Liverpool,Leicester,4,1,H,2016-09-10,4,1,1,1,3,0,3,0,3
4211,2016-09-10,Man United,Man City,1,2,A,2016-09-10,1,2,2,2,-1,0,0,3,-3
4212,2016-09-10,Middlesbrough,Crystal Palace,1,2,A,2016-09-10,1,2,2,2,-1,0,0,3,-3
4213,2016-09-10,Stoke,Tottenham,0,4,A,2016-09-10,0,4,4,4,-4,0,0,3,-3
4214,2016-09-10,West Ham,Watford,2,4,A,2016-09-10,2,4,4,4,-2,0,0,3,-3
4215,2016-09-11,Swansea,Chelsea,2,2,D,2016-09-17,2,3,2,2,0,1,1,1,0
4216,2016-09-12,Sunderland,Everton,0,3,A,2016-09-17,0,6,3,3,-3,3,0,3,-3
4217,2016-09-16,Chelsea,Liverpool,1,2,A,2016-09-17,3,2,4,4,-1,-2,0,3,-3
4218,2016-09-17,Everton,Middlesbrough,3,1,H,2016-09-17,6,1,1,1,5,0,3,0,3
4219,2016-09-17,Hull,Arsenal,1,4,A,2016-09-17,1,4,4,4,-3,0,0,3,-3
4220,2016-09-17,Leicester,Burnley,3,0,H,2016-09-17,3,0,0,0,3,0,3,0,3
4221,2016-09-17,Man City,Bournemouth,4,0,H,2016-09-17,4,0,0,0,4,0,3,0,3
4222,2016-09-17,West Brom,West Ham,4,2,H,2016-09-17,4,2,2,2,2,0,3,0,3
4223,2016-09-18,Crystal Palace,Stoke,4,1,H,2016-09-24,7,2,3,3,4,-1,3,0,3
4224,2016-09-18,Southampton,Swansea,1,0,H,2016-09-24,1,1,0,0,1,1,3,0,3
4225,2016-09-18,Tottenham,Sunderland,1,0,H,2016-09-24,3,2,1,1,2,1,3,0,3
4226,2016-09-18,Watford,Man United,3,1,H,2016-09-24,3,5,1,1,2,4,3,0,3
4227,2016-09-24,Arsenal,Chelsea,3,0,H,2016-09-24,3,0,0,0,3,0,3,0,3
4228,2016-09-24,Bournemouth,Everton,1,0,H,2016-09-24,1,0,0,0,1,0,3,0,3
4229,2016-09-24,Liverpool,Hull,5,1,H,2016-09-24,5,1,1,1,4,0,3,0,3
4230,2016-09-24,Man United,Leicester,4,1,H,2016-09-24,5,1,4,4,1,-3,3,0,3
4231,2016-09-24,Middlesbrough,Tottenham,1,2,A,2016-09-24,1,3,2,2,-1,1,0,3,-3
4232,2016-09-24,Stoke,West Brom,1,1,D,2016-09-24,2,1,5,5,-3,-4,1,1,0
4233,2016-09-24,Sunderland,Crystal Palace,2,3,A,2016-09-24,2,7,4,4,-2,3,0,3,-3
4234,2016-09-24,Swansea,Man City,1,3,A,2016-09-24,1,3,4,4,-3,-1,0,3,-3
4235,2016-09-25,West Ham,Southampton,0,3,A,2016-10-01,1,3,4,4,-3,-1,1,3,-2
4236,2016-09-26,Burnley,Watford,2,0,H,2016-10-01,2,2,0,0,2,2,3,0,3
4237,2016-09-30,Everton,Crystal Palace,1,1,D,2016-10-01,1,1,1,1,0,0,1,1,0
4238,2016-10-01,Hull,Chelsea,0,2,A,2016-10-01,0,2,2,2,-2,0,0,3,-3
4239,2016-10-01,Sunderland,West Brom,1,1,D,2016-10-01,1,1,1,1,0,0,1,1,0
4240,2016-10-01,Swansea,Liverpool,1,2,A,2016-10-01,1,2,2,2,-1,0,0,3,-3
4241,2016-10-01,Watford,Bournemouth,2,2,D,2016-10-01,2,2,4,4,-2,-2,1,1,0
4242,2016-10-01,West Ham,Middlesbrough,1,1,D,2016-10-01,1,1,4,4,-3,-3,1,1,0
4243,2016-10-02,Burnley,Arsenal,0,1,A,2016-10-08,0,1,1,1,-1,0,0,3,-3
4244,2016-10-02,Leicester,Southampton,0,0,D,2016-10-08,0,0,0,0,0,0,1,1,0
4245,2016-10-02,Man United,Stoke,1,1,D,2016-10-08,1,1,1,1,0,0,1,1,0
4246,2016-10-02,Tottenham,Man City,2,0,H,2016-10-08,2,0,0,0,2,0,3,0,3
4247,2016-10-15,Arsenal,Swansea,3,2,H,2016-10-15,3,2,2,2,1,0,3,0,3
4248,2016-10-15,Bournemouth,Hull,6,1,H,2016-10-15,6,1,1,1,5,0,3,0,3
4249,2016-10-15,Chelsea,Leicester,3,0,H,2016-10-15,3,0,0,0,3,0,3,0,3
4250,2016-10-15,Crystal Palace,West Ham,0,1,A,2016-10-15,0,1,1,1,-1,0,0,3,-3
4251,2016-10-15,Man City,Everton,1,1,D,2016-10-15,1,1,1,1,0,0,1,1,0
4252,2016-10-15,Stoke,Sunderland,2,0,H,2016-10-15,2,0,0,0,2,0,3,0,3
4253,2016-10-15,West Brom,Tottenham,1,1,D,2016-10-15,1,1,1,1,0,0,1,1,0
4254,2016-10-16,Middlesbrough,Watford,0,1,A,2016-10-22,0,1,1,1,-1,0,0,4,-4
4255,2016-10-16,Southampton,Burnley,3,1,H,2016-10-22,3,3,1,1,2,2,3,0,3
4256,2016-10-17,Liverpool,Man United,0,0,D,2016-10-22,2,0,1,1,1,-1,4,1,3
4257,2016-10-22,Arsenal,Middlesbrough,0,0,D,2016-10-22,0,0,0,0,0,0,1,1,0
4258,2016-10-22,Bournemouth,Tottenham,0,0,D,2016-10-22,0,0,0,0,0,0,1,1,0
4259,2016-10-22,Burnley,Everton,2,1,H,2016-10-22,3,1,4,4,-1,-3,3,0,3
4260,2016-10-22,Hull,Stoke,0,2,A,2016-10-22,0,2,2,2,-2,0,0,3,-3
4261,2016-10-22,Leicester,Crystal Palace,3,1,H,2016-10-22,3,1,1,1,2,0,3,0,3
4262,2016-10-22,Liverpool,West Brom,2,1,H,2016-10-22,2,1,1,1,1,0,4,0,4
4263,2016-10-22,Swansea,Watford,0,0,D,2016-10-22,0,1,0,0,0,1,1,4,-3
4264,2016-10-22,West Ham,Sunderland,1,0,H,2016-10-22,1,0,0,0,1,0,3,0,3
4265,2016-10-23,Chelsea,Man United,4,0,H,2016-10-29,4,0,0,0,4,0,3,0,3
4266,2016-10-23,Man City,Southampton,1,1,D,2016-10-29,5,1,1,1,4,0,1,1,0
4267,2016-10-29,Crystal Palace,Liverpool,2,4,A,2016-10-29,2,4,4,4,-2,0,0,3,-3
4268,2016-10-29,Man United,Burnley,0,0,D,2016-10-29,0,0,4,4,-4,-4,1,1,0
4269,2016-10-29,Middlesbrough,Bournemouth,2,0,H,2016-10-29,2,0,0,0,2,0,3,0,3
4270,2016-10-29,Sunderland,Arsenal,1,4,A,2016-10-29,1,4,4,4,-3,0,0,3,-3
4271,2016-10-29,Tottenham,Leicester,1,1,D,2016-10-29,1,1,1,1,0,0,1,1,0
4272,2016-10-29,Watford,Hull,1,0,H,2016-10-29,1,0,0,0,1,0,3,0,3
4273,2016-10-29,West Brom,Man City,0,4,A,2016-10-29,0,5,4,4,-4,1,0,3,-3
4274,2016-10-30,Everton,West Ham,2,0,H,2016-11-05,2,1,5,5,-3,-4,3,0,3
4275,2016-10-30,Southampton,Chelsea,0,2,A,2016-11-05,0,7,2,2,-2,5,0,3,-3
4276,2016-10-31,Stoke,Swansea,3,1,H,2016-11-05,4,1,2,2,2,-1,3,0,3
4277,2016-11-05,Bournemouth,Sunderland,1,2,A,2016-11-05,1,2,2,2,-1,0,0,3,-3
4278,2016-11-05,Burnley,Crystal Palace,3,2,H,2016-11-05,3,2,2,2,1,0,3,0,3
4279,2016-11-05,Chelsea,Everton,5,0,H,2016-11-05,7,2,0,0,7,2,3,0,3
4280,2016-11-05,Man City,Middlesbrough,1,1,D,2016-11-05,1,1,1,1,0,0,1,1,0
4281,2016-11-05,West Ham,Stoke,1,1,D,2016-11-05,1,4,3,3,-2,1,1,1,0
4282,2016-11-06,Arsenal,Tottenham,1,1,D,2016-11-12,1,1,1,1,0,0,1,1,0
4283,2016-11-06,Hull,Southampton,2,1,H,2016-11-12,2,1,1,1,1,0,3,0,3
4284,2016-11-06,Leicester,West Brom,1,2,A,2016-11-12,1,2,2,2,-1,0,0,3,-3
4285,2016-11-06,Liverpool,Watford,6,1,H,2016-11-12,6,1,1,1,5,0,3,0,3
4286,2016-11-06,Swansea,Man United,1,3,A,2016-11-12,1,3,3,3,-2,0,0,3,-3
4287,2016-11-19,Crystal Palace,Man City,1,2,A,2016-11-19,1,2,2,2,-1,0,0,3,-3
4288,2016-11-19,Everton,Swansea,1,1,D,2016-11-19,1,1,1,1,0,0,1,1,0
4289,2016-11-19,Man United,Arsenal,1,1,D,2016-11-19,1,1,1,1,0,0,1,1,0
4290,2016-11-19,Southampton,Liverpool,0,0,D,2016-11-19,0,0,0,0,0,0,1,1,0
4291,2016-11-19,Stoke,Bournemouth,0,1,A,2016-11-19,0,1,1,1,-1,0,0,3,-3
4292,2016-11-19,Sunderland,Hull,3,0,H,2016-11-19,3,0,0,0,3,0,3,0,3
4293,2016-11-19,Tottenham,West Ham,3,2,H,2016-11-19,3,2,2,2,1,0,3,0,3
4294,2016-11-19,Watford,Leicester,2,1,H,2016-11-19,2,1,1,1,1,0,3,0,3
4295,2016-11-20,Middlesbrough,Chelsea,0,1,A,2016-11-26,2,3,3,3,-1,0,0,3,-3
4296,2016-11-21,West Brom,Burnley,4,0,H,2016-11-26,5,1,1,1,4,0,3,0,3
4297,2016-11-26,Burnley,Man City,1,2,A,2016-11-26,1,2,6,6,-5,-4,0,3,-3
4298,2016-11-26,Chelsea,Tottenham,2,1,H,2016-11-26,3,1,1,1,2,0,3,0,3
4299,2016-11-26,Hull,West Brom,1,1,D,2016-11-26,1,5,1,1,0,4,1,1,0
4300,2016-11-26,Leicester,Middlesbrough,2,2,D,2016-11-26,2,2,2,2,0,0,1,1,0
4301,2016-11-26,Liverpool,Sunderland,2,0,H,2016-11-26,2,0,0,0,2,0,3,0,3
4302,2016-11-26,Swansea,Crystal Palace,5,4,H,2016-11-26,5,4,4,4,1,0,3,0,3
4303,2016-11-27,Arsenal,Bournemouth,3,1,H,2016-12-03,8,1,2,2,6,-1,3,0,3
4304,2016-11-27,Man United,West Ham,1,1,D,2016-12-03,1,2,1,1,0,1,1,1,0
4305,2016-11-27,Southampton,Everton,1,0,H,2016-12-03,1,0,3,3,-2,-3,3,0,3
4306,2016-11-27,Watford,Stoke,0,1,A,2016-12-03,1,3,4,4,-3,-1,0,3,-3
4307,2016-12-03,Crystal Palace,Southampton,3,0,H,2016-12-03,3,1,0,0,3,1,3,0,3
4308,2016-12-03,Man City,Chelsea,1,3,A,2016-12-03,1,3,3,3,-2,0,0,3,-3
4309,2016-12-03,Stoke,Burnley,2,0,H,2016-12-03,3,0,0,0,3,0,3,0,3
4310,2016-12-03,Sunderland,Leicester,2,1,H,2016-12-03,2,1,1,1,1,0,3,0,3
4311,2016-12-03,Tottenham,Swansea,5,0,H,2016-12-03,5,0,0,0,5,0,3,0,3
4312,2016-12-03,West Brom,Watford,3,1,H,2016-12-03,3,1,1,1,2,0,3,0,3
4313,2016-12-03,West Ham,Arsenal,1,5,A,2016-12-03,2,8,6,6,-4,2,0,3,-3
4314,2016-12-04,Bournemouth,Liverpool,4,3,H,2016-12-10,6,3,6,6,0,-3,3,0,3
4315,2016-12-04,Everton,Man United,1,1,D,2016-12-10,3,1,4,4,-1,-3,1,1,0
4316,2016-12-05,Middlesbrough,Hull,1,0,H,2016-12-10,1,3,0,0,1,3,3,0,3
4317,2016-12-10,Arsenal,Stoke,3,1,H,2016-12-10,3,1,1,1,2,0,3,0,3
4318,2016-12-10,Burnley,Bournemouth,3,2,H,2016-12-10,3,6,2,2,1,4,3,0,3
4319,2016-12-10,Hull,Crystal Palace,3,3,D,2016-12-10,3,3,4,4,-1,-1,1,1,0
4320,2016-12-10,Leicester,Man City,4,2,H,2016-12-10,4,2,2,2,2,0,3,0,3
4321,2016-12-10,Swansea,Sunderland,3,0,H,2016-12-10,3,0,0,0,3,0,3,0,3
4322,2016-12-10,Watford,Everton,3,2,H,2016-12-10,3,3,2,2,1,1,3,0,3
4323,2016-12-11,Chelsea,West Brom,1,0,H,2016-12-17,3,3,0,0,3,3,3,0,3
4324,2016-12-11,Liverpool,West Ham,2,2,D,2016-12-17,5,4,2,2,3,2,1,1,0
4325,2016-12-11,Man United,Tottenham,1,0,H,2016-12-17,5,3,1,1,4,2,3,0,3
4326,2016-12-11,Southampton,Middlesbrough,1,0,H,2016-12-17,1,3,0,0,1,3,3,0,3
4327,2016-12-13,Bournemouth,Leicester,1,0,H,2016-12-17,1,2,0,0,1,2,3,1,2
4328,2016-12-13,Everton,Arsenal,2,1,H,2016-12-17,2,1,1,1,1,0,3,0,3
4329,2016-12-14,Crystal Palace,Man United,1,2,A,2016-12-17,1,5,3,3,-2,2,0,6,-6
4330,2016-12-14,Man City,Watford,2,0,H,2016-12-17,2,0,0,0,2,0,3,0,3
4331,2016-12-14,Middlesbrough,Liverpool,0,3,A,2016-12-17,3,5,4,4,-1,1,3,3,0
4332,2016-12-14,Stoke,Southampton,0,0,D,2016-12-17,2,1,2,2,0,-1,2,1,1
4333,2016-12-14,Sunderland,Chelsea,0,1,A,2016-12-17,1,3,1,1,0,2,3,6,-3
4334,2016-12-14,Tottenham,Hull,3,0,H,2016-12-17,3,0,1,1,2,-1,3,0,3
4335,2016-12-14,West Brom,Swansea,3,1,H,2016-12-17,3,1,4,4,-1,-3,3,0,3
4336,2016-12-14,West Ham,Burnley,1,0,H,2016-12-17,4,0,2,2,2,-2,6,0,6
4337,2016-12-17,Crystal Palace,Chelsea,0,1,A,2016-12-17,1,3,3,3,-2,0,0,6,-6
4338,2016-12-17,Middlesbrough,Swansea,3,0,H,2016-12-17,3,1,4,4,-1,-3,3,0,3
4339,2016-12-17,Stoke,Leicester,2,2,D,2016-12-17,2,2,2,2,0,0,2,1,1
4340,2016-12-17,Sunderland,Watford,1,0,H,2016-12-17,1,0,1,1,0,-1,3,0,3
4341,2016-12-17,West Brom,Man United,0,2,A,2016-12-17,3,5,4,4,-1,1,3,6,-3
4342,2016-12-17,West Ham,Hull,1,0,H,2016-12-17,4,0,2,2,2,-2,6,0,6
4343,2016-12-18,Bournemouth,Southampton,1,3,A,2016-12-24,1,3,3,3,-2,0,0,3,-3
4344,2016-12-18,Man City,Arsenal,2,1,H,2016-12-24,2,1,1,1,1,0,3,0,3
4345,2016-12-18,Tottenham,Burnley,2,1,H,2016-12-24,2,1,1,1,1,0,3,0,3
4346,2016-12-19,Everton,Liverpool,0,1,A,2016-12-24,0,1,1,1,-1,0,0,3,-3
4347,2016-12-26,Arsenal,West Brom,1,0,H,2016-12-31,1,2,0,0,1,2,3,3,0
4348,2016-12-26,Burnley,Middlesbrough,1,0,H,2016-12-31,5,1,1,1,4,0,6,0,6
4349,2016-12-26,Chelsea,Bournemouth,3,0,H,2016-12-31,7,3,2,2,5,1,6,3,3
4350,2016-12-26,Hull,Man City,0,3,A,2016-12-31,2,3,5,5,-3,-2,1,3,-2
4351,2016-12-26,Leicester,Everton,0,2,A,2016-12-31,1,4,2,2,-1,2,3,4,-1
4352,2016-12-26,Man United,Sunderland,3,1,H,2016-12-31,5,2,2,2,3,0,6,0,6
4353,2016-12-26,Swansea,West Ham,1,4,A,2016-12-31,1,4,7,7,-6,-3,0,3,-3
4354,2016-12-26,Watford,Crystal Palace,1,1,D,2016-12-31,1,1,1,1,0,0,1,1,0
4355,2016-12-27,Liverpool,Stoke,4,1,H,2016-12-31,5,3,1,1,4,2,6,0,6
4356,2016-12-28,Southampton,Tottenham,1,4,A,2016-12-31,2,4,6,6,-4,-2,0,3,-3
4357,2016-12-30,Hull,Everton,2,2,D,2016-12-31,2,4,5,5,-3,-1,1,4,-3
4358,2016-12-31,Burnley,Sunderland,4,1,H,2016-12-31,5,2,1,1,4,1,6,0,6
4359,2016-12-31,Chelsea,Stoke,4,2,H,2016-12-31,7,3,2,2,5,1,6,0,6
4360,2016-12-31,Leicester,West Ham,1,0,H,2016-12-31,1,4,2,2,-1,2,3,3,0
4361,2016-12-31,Liverpool,Man City,1,0,H,2016-12-31,5,3,1,1,4,2,6,3,3
4362,2016-12-31,Man United,Middlesbrough,2,1,H,2016-12-31,5,1,2,2,3,-1,6,0,6
4363,2016-12-31,Southampton,West Brom,1,2,A,2016-12-31,2,2,6,6,-4,-4,0,3,-3
4364,2016-12-31,Swansea,Bournemouth,0,3,A,2016-12-31,1,3,7,7,-6,-4,0,3,-3
4365,2017-01-01,Arsenal,Crystal Palace,2,0,H,2017-01-07,5,1,3,3,2,-2,3,0,3
4366,2017-01-01,Watford,Tottenham,1,4,A,2017-01-07,1,6,6,6,-5,0,0,3,-3
4367,2017-01-02,Everton,Southampton,3,0,H,2017-01-07,3,0,0,0,3,0,3,0,3
4368,2017-01-02,Man City,Burnley,2,1,H,2017-01-07,2,1,1,1,1,0,3,0,3
4369,2017-01-02,Middlesbrough,Leicester,0,0,D,2017-01-07,0,0,0,0,0,0,1,1,0
4370,2017-01-02,Sunderland,Liverpool,2,2,D,2017-01-07,2,2,2,2,0,0,1,1,0
4371,2017-01-02,West Brom,Hull,3,1,H,2017-01-07,3,1,1,1,2,0,3,0,3
4372,2017-01-02,West Ham,Man United,0,2,A,2017-01-07,0,2,2,2,-2,0,0,3,-3
4373,2017-01-03,Bournemouth,Arsenal,3,3,D,2017-01-07,3,5,3,3,0,2,1,1,0
4374,2017-01-03,Crystal Palace,Swansea,1,2,A,2017-01-07,1,2,4,4,-3,-2,0,3,-3
4375,2017-01-03,Stoke,Watford,2,0,H,2017-01-07,2,1,0,0,2,1,3,0,3
4376,2017-01-04,Tottenham,Chelsea,2,0,H,2017-01-07,6,0,1,1,5,-1,3,0,3
4377,2017-01-14,Burnley,Southampton,1,0,H,2017-01-14,1,0,0,0,1,0,3,0,3
4378,2017-01-14,Hull,Bournemouth,3,1,H,2017-01-14,3,1,1,1,2,0,3,0,3
4379,2017-01-14,Leicester,Chelsea,0,3,A,2017-01-14,0,3,3,3,-3,0,0,3,-3
4380,2017-01-14,Sunderland,Stoke,1,3,A,2017-01-14,1,3,3,3,-2,0,0,3,-3
4381,2017-01-14,Swansea,Arsenal,0,4,A,2017-01-14,0,4,4,4,-4,0,0,3,-3
4382,2017-01-14,Tottenham,West Brom,4,0,H,2017-01-14,4,0,0,0,4,0,3,0,3
4383,2017-01-14,Watford,Middlesbrough,0,0,D,2017-01-14,0,0,0,0,0,0,1,1,0
4384,2017-01-14,West Ham,Crystal Palace,3,0,H,2017-01-14,3,0,0,0,3,0,3,0,3
4385,2017-01-15,Everton,Man City,4,0,H,2017-01-21,5,2,0,0,5,2,3,0,3
4386,2017-01-15,Man United,Liverpool,1,1,D,2017-01-21,2,3,2,2,0,1,1,1,0
4387,2017-01-21,Bournemouth,Watford,2,2,D,2017-01-21,2,2,2,2,0,0,1,1,0
4388,2017-01-21,Crystal Palace,Everton,0,1,A,2017-01-21,0,5,1,1,-1,4,0,3,-3
4389,2017-01-21,Liverpool,Swansea,2,3,A,2017-01-21,3,3,4,4,-1,-1,0,3,-3
4390,2017-01-21,Man City,Tottenham,2,2,D,2017-01-21,2,2,6,6,-4,-4,1,1,0
4391,2017-01-21,Middlesbrough,West Ham,1,3,A,2017-01-21,1,3,3,3,-2,0,0,3,-3
4392,2017-01-21,Stoke,Man United,1,1,D,2017-01-21,1,2,1,1,0,1,1,1,0
4393,2017-01-21,West Brom,Sunderland,2,0,H,2017-01-21,2,0,0,0,2,0,3,0,3
4394,2017-01-22,Arsenal,Burnley,2,1,H,2017-01-28,2,1,1,1,1,0,3,0,3
4395,2017-01-22,Chelsea,Hull,2,0,H,2017-01-28,2,0,0,0,2,0,3,0,3
4396,2017-01-22,Southampton,Leicester,3,0,H,2017-01-28,3,0,0,0,3,0,3,0,3
4397,2017-01-31,Arsenal,Watford,1,2,A,2017-02-04,2,4,5,5,-3,-1,0,3,-3
4398,2017-01-31,Bournemouth,Crystal Palace,0,2,A,2017-02-04,3,2,8,8,-5,-6,0,3,-3
4399,2017-01-31,Burnley,Leicester,1,0,H,2017-02-04,2,0,2,2,0,-2,3,0,3
4400,2017-01-31,Liverpool,Chelsea,1,1,D,2017-02-04,1,4,3,3,-2,1,1,1,0
4401,2017-01-31,Middlesbrough,West Brom,1,1,D,2017-02-04,1,2,2,2,-1,0,1,1,0
4402,2017-01-31,Sunderland,Tottenham,0,0,D,2017-02-04,4,1,0,0,4,1,1,1,0
4403,2017-01-31,Swansea,Southampton,2,1,H,2017-02-04,2,2,1,1,1,1,3,0,3
4404,2017-02-01,Man United,Hull,0,0,D,2017-02-04,0,2,0,0,0,2,1,1,0
4405,2017-02-01,Stoke,Everton,1,1,D,2017-02-04,1,7,2,2,-1,5,1,1,0
4406,2017-02-01,West Ham,Man City,0,4,A,2017-02-04,3,4,5,5,-2,-1,0,3,-3
4407,2017-02-04,Chelsea,Arsenal,3,1,H,2017-02-04,4,2,2,2,2,0,3,0,3
4408,2017-02-04,Crystal Palace,Sunderland,0,4,A,2017-02-04,2,4,4,4,-2,0,0,3,-3
4409,2017-02-04,Everton,Bournemouth,6,3,H,2017-02-04,7,3,4,4,3,-1,3,0,3
4410,2017-02-04,Hull,Liverpool,2,0,H,2017-02-04,2,1,0,0,2,1,3,0,3
4411,2017-02-04,Southampton,West Ham,1,3,A,2017-02-04,2,3,5,5,-3,-2,0,3,-3
4412,2017-02-04,Tottenham,Middlesbrough,1,0,H,2017-02-04,1,1,0,0,1,1,3,0,3
4413,2017-02-04,Watford,Burnley,2,1,H,2017-02-04,4,2,2,2,2,0,3,0,3
4414,2017-02-04,West Brom,Stoke,1,0,H,2017-02-04,2,1,1,1,1,0,3,0,3
4415,2017-02-05,Leicester,Man United,0,3,A,2017-02-11,0,5,3,3,-3,2,0,3,-3
4416,2017-02-05,Man City,Swansea,2,1,H,2017-02-11,2,1,1,1,1,0,3,0,3
4417,2017-02-11,Arsenal,Hull,2,0,H,2017-02-11,2,0,0,0,2,0,3,0,3
4418,2017-02-11,Liverpool,Tottenham,2,0,H,2017-02-11,2,0,0,0,2,0,3,0,3
4419,2017-02-11,Man United,Watford,2,0,H,2017-02-11,5,0,0,0,5,0,3,0,3
4420,2017-02-11,Middlesbrough,Everton,0,0,D,2017-02-11,0,0,0,0,0,0,1,1,0
4421,2017-02-11,Stoke,Crystal Palace,1,0,H,2017-02-11,1,0,0,0,1,0,3,0,3
4422,2017-02-11,Sunderland,Southampton,0,4,A,2017-02-11,0,4,4,4,-4,0,0,3,-3
4423,2017-02-11,West Ham,West Brom,2,2,D,2017-02-11,2,2,2,2,0,0,1,1,0
4424,2017-02-12,Burnley,Chelsea,1,1,D,2017-02-18,1,1,1,1,0,0,1,1,0
4425,2017-02-12,Swansea,Leicester,2,0,H,2017-02-18,2,0,0,0,2,0,3,0,3
4426,2017-02-13,Bournemouth,Man City,0,2,A,2017-02-18,0,2,2,2,-2,0,0,3,-3
4427,2017-02-25,Chelsea,Swansea,3,1,H,2017-02-25,3,1,1,1,2,0,3,0,3
4428,2017-02-25,Crystal Palace,Middlesbrough,1,0,H,2017-02-25,1,0,0,0,1,0,3,0,3
4429,2017-02-25,Everton,Sunderland,2,0,H,2017-02-25,2,0,0,0,2,0,3,0,3
4430,2017-02-25,Hull,Burnley,1,1,D,2017-02-25,1,1,1,1,0,0,1,1,0
4431,2017-02-25,Watford,West Ham,1,1,D,2017-02-25,1,1,1,1,0,0,1,1,0
4432,2017-02-25,West Brom,Bournemouth,2,1,H,2017-02-25,2,1,1,1,1,0,3,0,3
4433,2017-02-26,Tottenham,Stoke,4,0,H,2017-03-04,4,2,0,0,4,2,3,0,3
4434,2017-02-27,Leicester,Liverpool,3,1,H,2017-03-04,6,4,2,2,4,2,6,0,6
4435,2017-03-04,Leicester,Hull,3,1,H,2017-03-04,6,1,2,2,4,-1,6,0,6
4436,2017-03-04,Liverpool,Arsenal,3,1,H,2017-03-04,4,1,4,4,0,-3,3,0,3
4437,2017-03-04,Man United,Bournemouth,1,1,D,2017-03-04,1,1,1,1,0,0,1,1,0
4438,2017-03-04,Stoke,Middlesbrough,2,0,H,2017-03-04,2,0,4,4,-2,-4,3,0,3
4439,2017-03-04,Swansea,Burnley,3,2,H,2017-03-04,3,2,2,2,1,0,3,0,3
4440,2017-03-04,Watford,Southampton,3,4,A,2017-03-04,3,4,4,4,-1,0,0,3,-3
4441,2017-03-04,West Brom,Crystal Palace,0,2,A,2017-03-04,0,2,2,2,-2,0,0,3,-3
4442,2017-03-05,Sunderland,Man City,0,2,A,2017-03-11,0,2,2,2,-2,0,0,3,-3
4443,2017-03-05,Tottenham,Everton,3,2,H,2017-03-11,3,5,2,2,1,3,3,0,3
4444,2017-03-06,West Ham,Chelsea,1,2,A,2017-03-11,3,2,5,5,-2,-3,0,3,-3
4445,2017-03-08,Man City,Stoke,0,0,D,2017-03-11,2,0,0,0,2,0,1,1,0
4446,2017-03-11,Bournemouth,West Ham,3,2,H,2017-03-11,3,3,2,2,1,1,3,0,3
4447,2017-03-11,Everton,West Brom,3,0,H,2017-03-11,5,0,3,3,2,-3,3,0,3
4448,2017-03-11,Hull,Swansea,2,1,H,2017-03-11,2,1,1,1,1,0,3,0,3
4449,2017-03-12,Liverpool,Burnley,2,1,H,2017-03-18,2,1,1,1,1,0,3,1,2
4450,2017-03-18,Bournemouth,Swansea,2,0,H,2017-03-18,2,0,0,0,2,0,3,0,3
4451,2017-03-18,Crystal Palace,Watford,1,0,H,2017-03-18,1,0,0,0,1,0,3,0,3
4452,2017-03-18,Everton,Hull,4,0,H,2017-03-18,4,0,0,0,4,0,3,0,3
4453,2017-03-18,Stoke,Chelsea,1,2,A,2017-03-18,1,2,2,2,-1,0,0,3,-3
4454,2017-03-18,Sunderland,Burnley,0,0,D,2017-03-18,0,1,0,0,0,1,1,1,0
4455,2017-03-18,West Brom,Arsenal,3,1,H,2017-03-18,3,1,1,1,2,0,3,0,3
4456,2017-03-18,West Ham,Leicester,2,3,A,2017-03-18,2,3,3,3,-1,0,0,3,-3
4457,2017-03-19,Man City,Liverpool,1,1,D,2017-03-25,1,1,1,1,0,0,1,1,0
4458,2017-03-19,Middlesbrough,Man United,1,3,A,2017-03-25,1,3,3,3,-2,0,0,3,-3
4459,2017-03-19,Tottenham,Southampton,2,1,H,2017-03-25,2,1,1,1,1,0,3,0,3
4460,2017-04-01,Burnley,Tottenham,0,2,A,2017-04-01,0,2,2,2,-2,0,0,3,-3
4461,2017-04-01,Chelsea,Crystal Palace,1,2,A,2017-04-01,1,2,2,2,-1,0,0,3,-3
4462,2017-04-01,Hull,West Ham,2,1,H,2017-04-01,2,1,1,1,1,0,3,0,3
4463,2017-04-01,Leicester,Stoke,2,0,H,2017-04-01,2,0,0,0,2,0,3,0,3
4464,2017-04-01,Liverpool,Everton,3,1,H,2017-04-01,3,1,1,1,2,0,3,0,3
4465,2017-04-01,Man United,West Brom,0,0,D,2017-04-01,0,0,0,0,0,0,1,1,0
4466,2017-04-01,Southampton,Bournemouth,0,0,D,2017-04-01,0,0,0,0,0,0,1,1,0
4467,2017-04-01,Watford,Sunderland,1,0,H,2017-04-01,1,0,0,0,1,0,3,0,3
4468,2017-04-02,Arsenal,Man City,2,2,D,2017-04-08,5,6,2,2,3,4,4,1,3
4469,2017-04-02,Swansea,Middlesbrough,0,0,D,2017-04-08,1,2,4,4,-3,-2,1,1,0
4470,2017-04-04,Burnley,Stoke,1,0,H,2017-04-08,1,1,0,0,1,1,3,0,3
4471,2017-04-04,Leicester,Sunderland,2,0,H,2017-04-08,2,0,0,0,2,0,3,0,3
4472,2017-04-04,Man United,Everton,1,1,D,2017-04-08,1,1,1,1,0,0,1,1,0
4473,2017-04-04,Watford,West Brom,2,0,H,2017-04-08,2,0,4,4,-2,-4,3,0,3
4474,2017-04-05,Arsenal,West Ham,3,0,H,2017-04-08,5,1,2,2,3,-1,4,0,4
4475,2017-04-05,Chelsea,Man City,2,1,H,2017-04-08,5,6,2,2,3,4,3,1,2
4476,2017-04-05,Hull,Middlesbrough,4,2,H,2017-04-08,5,2,5,5,0,-3,3,1,2
4477,2017-04-05,Liverpool,Bournemouth,2,2,D,2017-04-08,4,3,3,3,1,0,1,1,0
4478,2017-04-05,Southampton,Crystal Palace,3,1,H,2017-04-08,4,1,1,1,3,0,3,0,3
4479,2017-04-05,Swansea,Tottenham,1,3,A,2017-04-08,1,7,4,4,-3,3,1,3,-2
4480,2017-04-08,Bournemouth,Chelsea,1,3,A,2017-04-08,3,5,5,5,-2,0,0,3,-3
4481,2017-04-08,Man City,Hull,3,1,H,2017-04-08,6,5,5,5,1,0,3,0,3
4482,2017-04-08,Middlesbrough,Burnley,0,0,D,2017-04-08,2,1,4,4,-2,-3,1,1,0
4483,2017-04-08,Stoke,Liverpool,1,2,A,2017-04-08,1,4,3,3,-2,1,0,3,-3
4484,2017-04-08,Tottenham,Watford,4,0,H,2017-04-08,7,2,1,1,6,1,3,0,3
4485,2017-04-08,West Brom,Southampton,0,1,A,2017-04-08,0,4,3,3,-3,1,0,3,-3
4486,2017-04-08,West Ham,Swansea,1,0,H,2017-04-08,1,1,3,3,-2,-2,3,0,3
4487,2017-04-09,Everton,Leicester,4,2,H,2017-04-15,7,4,3,3,4,1,6,1,5
4488,2017-04-09,Sunderland,Man United,0,3,A,2017-04-15,2,3,5,5,-3,-2,1,3,-2
4489,2017-04-10,Crystal Palace,Arsenal,3,0,H,2017-04-15,5,0,2,2,3,-2,4,0,4
4490,2017-04-15,Crystal Palace,Leicester,2,2,D,2017-04-15,5,4,2,2,3,2,4,1,3
4491,2017-04-15,Everton,Burnley,3,1,H,2017-04-15,7,1,3,3,4,-2,6,0,6
4492,2017-04-15,Southampton,Man City,0,3,A,2017-04-15,0,3,3,3,-3,0,0,3,-3
4493,2017-04-15,Stoke,Hull,3,1,H,2017-04-15,3,1,1,1,2,0,3,0,3
4494,2017-04-15,Sunderland,West Ham,2,2,D,2017-04-15,2,2,5,5,-3,-3,1,1,0
4495,2017-04-15,Tottenham,Bournemouth,4,0,H,2017-04-15,4,0,0,0,4,0,3,0,3
4496,2017-04-15,Watford,Swansea,1,0,H,2017-04-15,1,0,0,0,1,0,3,0,3
4497,2017-04-16,Man United,Chelsea,2,0,H,2017-04-22,2,0,0,0,2,0,3,0,3
4498,2017-04-16,West Brom,Liverpool,0,1,A,2017-04-22,0,1,1,1,-1,0,0,3,-3
4499,2017-04-17,Middlesbrough,Arsenal,1,2,A,2017-04-22,1,2,6,6,-5,-4,0,3,-3
4500,2017-04-22,Bournemouth,Middlesbrough,4,0,H,2017-04-22,4,1,0,0,4,1,3,0,3
4501,2017-04-22,Hull,Watford,2,0,H,2017-04-22,2,0,0,0,2,0,3,0,3
4502,2017-04-22,Swansea,Stoke,2,0,H,2017-04-22,2,0,0,0,2,0,3,0,3
4503,2017-04-22,West Ham,Everton,0,0,D,2017-04-22,0,0,0,0,0,0,1,1,0
4504,2017-04-23,Burnley,Man United,0,2,A,2017-04-29,2,2,2,2,0,0,0,4,-4
4505,2017-04-23,Liverpool,Crystal Palace,1,2,A,2017-04-29,1,2,2,2,-1,0,0,3,-3
4506,2017-04-25,Chelsea,Southampton,4,2,H,2017-04-29,4,2,2,2,2,0,3,0,3
4507,2017-04-26,Arsenal,Leicester,1,0,H,2017-04-29,1,1,0,0,1,1,3,3,0
4508,2017-04-26,Crystal Palace,Tottenham,0,1,A,2017-04-29,2,1,4,4,-2,-3,0,3,-3
4509,2017-04-26,Middlesbrough,Sunderland,1,0,H,2017-04-29,1,0,0,0,1,0,3,0,3
4510,2017-04-27,Man City,Man United,0,0,D,2017-04-29,0,2,0,0,0,2,1,4,-3
4511,2017-04-29,Crystal Palace,Burnley,0,2,A,2017-04-29,2,2,4,4,-2,-2,0,3,-3
4512,2017-04-29,Southampton,Hull,0,0,D,2017-04-29,2,0,4,4,-2,-4,1,1,0
4513,2017-04-29,Stoke,West Ham,0,0,D,2017-04-29,0,0,0,0,0,0,1,1,0
4514,2017-04-29,Sunderland,Bournemouth,0,1,A,2017-04-29,0,1,2,2,-2,-1,0,3,-3
4515,2017-04-29,West Brom,Leicester,0,1,A,2017-04-29,0,1,1,1,-1,0,0,3,-3
4516,2017-04-30,Everton,Chelsea,0,3,A,2017-05-06,0,3,4,4,-4,-1,0,3,-3
4517,2017-04-30,Man United,Swansea,1,1,D,2017-05-06,1,2,1,1,0,1,1,1,0
4518,2017-04-30,Middlesbrough,Man City,2,2,D,2017-05-06,2,7,2,2,0,5,1,1,0
4519,2017-04-30,Tottenham,Arsenal,2,0,H,2017-05-06,2,0,1,1,1,-1,3,0,3
4520,2017-05-01,Watford,Liverpool,0,1,A,2017-05-06,0,1,4,4,-4,-3,0,3,-3
4521,2017-05-05,West Ham,Tottenham,1,0,H,2017-05-06,1,2,0,0,1,2,3,0,3
4522,2017-05-06,Bournemouth,Stoke,2,2,D,2017-05-06,2,2,2,2,0,0,1,1,0
4523,2017-05-06,Burnley,West Brom,2,2,D,2017-05-06,2,2,2,2,0,0,1,1,0
4524,2017-05-06,Hull,Sunderland,0,2,A,2017-05-06,0,2,2,2,-2,0,0,3,-3
4525,2017-05-06,Leicester,Watford,3,0,H,2017-05-06,3,0,0,0,3,0,3,0,3
4526,2017-05-06,Man City,Crystal Palace,5,0,H,2017-05-06,7,0,2,2,5,-2,3,0,3
4527,2017-05-06,Swansea,Everton,1,0,H,2017-05-06,2,0,1,1,1,-1,3,0,3
4528,2017-05-07,Arsenal,Man United,2,0,H,2017-05-13,8,0,1,1,7,-1,3,0,3
4529,2017-05-07,Liverpool,Southampton,0,0,D,2017-05-13,0,2,0,0,0,2,1,4,-3
4530,2017-05-08,Chelsea,Middlesbrough,3,0,H,2017-05-13,4,1,0,0,4,1,3,0,3
4531,2017-05-10,Southampton,Arsenal,0,2,A,2017-05-13,2,8,3,3,-1,5,0,6,-6
4532,2017-05-12,Everton,Watford,1,0,H,2017-05-13,1,0,0,0,1,0,3,0,3
4533,2017-05-12,West Brom,Chelsea,0,1,A,2017-05-13,0,4,1,1,-1,3,0,3,-3
4534,2017-05-13,Bournemouth,Burnley,2,1,H,2017-05-13,2,1,1,1,1,0,3,0,3
4535,2017-05-13,Man City,Leicester,2,1,H,2017-05-13,2,1,1,1,1,0,3,0,3
4536,2017-05-13,Middlesbrough,Southampton,1,2,A,2017-05-13,1,2,5,5,-4,-3,0,4,-4
4537,2017-05-13,Stoke,Arsenal,1,4,A,2017-05-13,1,8,4,4,-3,4,0,6,-6
4538,2017-05-13,Sunderland,Swansea,0,2,A,2017-05-13,0,2,2,2,-2,0,0,3,-3
4539,2017-05-14,Crystal Palace,Hull,4,0,H,2017-05-20,4,0,0,0,4,0,3,0,3
4540,2017-05-14,Tottenham,Man United,2,1,H,2017-05-20,8,1,2,2,6,-1,3,1,2
4541,2017-05-14,West Ham,Liverpool,0,4,A,2017-05-20,0,4,4,4,-4,0,0,3,-3
4542,2017-05-15,Chelsea,Watford,4,3,H,2017-05-20,4,3,3,3,1,0,3,0,3
4543,2017-05-16,Arsenal,Sunderland,2,0,H,2017-05-20,2,0,0,0,2,0,3,0,3
4544,2017-05-16,Man City,West Brom,3,1,H,2017-05-20,3,1,1,1,2,0,3,0,3
4545,2017-05-17,Southampton,Man United,0,0,D,2017-05-20,0,1,0,0,0,1,1,1,0
4546,2017-05-18,Leicester,Tottenham,1,6,A,2017-05-20,1,8,6,6,-5,2,0,3,-3
4547,2017-05-21,Arsenal,Everton,3,1,H,2017-05-27,3,1,1,1,2,0,3,0,3
4548,2017-05-21,Burnley,West Ham,1,2,A,2017-05-27,1,2,2,2,-1,0,0,3,-3
4549,2017-05-21,Chelsea,Sunderland,5,1,H,2017-05-27,5,1,1,1,4,0,3,0,3
4550,2017-05-21,Hull,Tottenham,1,7,A,2017-05-27,1,7,7,7,-6,0,0,3,-3
4551,2017-05-21,Leicester,Bournemouth,1,1,D,2017-05-27,1,1,1,1,0,0,1,1,0
4552,2017-05-21,Liverpool,Middlesbrough,3,0,H,2017-05-27,3,0,0,0,3,0,3,0,3
4553,2017-05-21,Man United,Crystal Palace,2,0,H,2017-05-27,2,0,0,0,2,0,3,0,3
4554,2017-05-21,Southampton,Stoke,0,1,A,2017-05-27,0,1,1,1,-1,0,0,3,-3
4555,2017-05-21,Swansea,West Brom,2,1,H,2017-05-27,2,1,1,1,1,0,3,0,3
4556,2017-05-21,Watford,Man City,0,5,A,2017-05-27,0,5,5,5,-5,0,0,3,-3
4557,2017-08-11,Arsenal,Leicester,4,3,H,2017-08-12,4,3,3,3,1,0,3,0,3
4558,2017-08-12,Brighton,Man City,0,2,A,2017-08-12,0,2,2,2,-2,0,0,3,-3
4559,2017-08-12,Chelsea,Burnley,2,3,A,2017-08-12,2,3,3,3,-1,0,0,3,-3
4560,2017-08-12,Crystal Palace,Huddersfield,0,3,A,2017-08-12,0,3,3,3,-3,0,0,3,-3
4561,2017-08-12,Everton,Stoke,1,0,H,2017-08-12,1,0,0,0,1,0,3,0,3
4562,2017-08-12,Southampton,Swansea,0,0,D,2017-08-12,0,0,0,0,0,0,1,1,0
4563,2017-08-12,Watford,Liverpool,3,3,D,2017-08-12,3,3,3,3,0,0,1,1,0
4564,2017-08-12,West Brom,Bournemouth,1,0,H,2017-08-12,1,0,0,0,1,0,3,0,3
4565,2017-08-13,Man United,West Ham,4,0,H,2017-08-19,8,2,0,0,8,2,3,0,3
4566,2017-08-13,Newcastle,Tottenham,0,2,A,2017-08-19,0,2,2,2,-2,0,0,3,-3
4567,2017-08-19,Bournemouth,Watford,0,2,A,2017-08-19,0,2,2,2,-2,0,0,3,-3
4568,2017-08-19,Burnley,West Brom,0,1,A,2017-08-19,0,1,1,1,-1,0,0,3,-3
4569,2017-08-19,Leicester,Brighton,2,0,H,2017-08-19,2,0,0,0,2,0,3,0,3
4570,2017-08-19,Liverpool,Crystal Palace,1,0,H,2017-08-19,1,0,0,0,1,0,3,0,3
4571,2017-08-19,Southampton,West Ham,3,2,H,2017-08-19,3,2,2,2,1,0,3,0,3
4572,2017-08-19,Stoke,Arsenal,1,0,H,2017-08-19,1,0,0,0,1,0,3,0,3
4573,2017-08-19,Swansea,Man United,0,4,A,2017-08-19,0,8,4,4,-4,4,0,3,-3
4574,2017-08-20,Huddersfield,Newcastle,1,0,H,2017-08-26,1,3,0,0,1,3,4,0,4
4575,2017-08-20,Tottenham,Chelsea,1,2,A,2017-08-26,1,2,2,2,-1,0,0,3,-3
4576,2017-08-21,Man City,Everton,1,1,D,2017-08-26,3,1,2,2,1,-1,1,1,0
4577,2017-08-26,Bournemouth,Man City,1,2,A,2017-08-26,1,3,2,2,-1,1,0,3,-3
4578,2017-08-26,Crystal Palace,Swansea,0,2,A,2017-08-26,0,2,2,2,-2,0,0,3,-3
4579,2017-08-26,Huddersfield,Southampton,0,0,D,2017-08-26,1,0,0,0,1,0,4,1,3
4580,2017-08-26,Man United,Leicester,2,0,H,2017-08-26,2,0,0,0,2,0,3,0,3
4581,2017-08-26,Newcastle,West Ham,3,0,H,2017-08-26,3,0,1,1,2,-1,3,0,3
4582,2017-08-26,Watford,Brighton,0,0,D,2017-08-26,0,0,0,0,0,0,1,1,0
4583,2017-08-27,Chelsea,Everton,2,0,H,2017-09-02,2,0,0,0,2,0,3,0,3
4584,2017-08-27,Liverpool,Arsenal,4,0,H,2017-09-02,4,0,0,0,4,0,3,0,3
4585,2017-08-27,Tottenham,Burnley,1,1,D,2017-09-02,1,1,1,1,0,0,1,1,0
4586,2017-08-27,West Brom,Stoke,1,1,D,2017-09-02,1,1,1,1,0,0,1,1,0
4587,2017-09-09,Arsenal,Bournemouth,3,0,H,2017-09-09,3,0,0,0,3,0,3,0,3
4588,2017-09-09,Brighton,West Brom,3,1,H,2017-09-09,3,1,1,1,2,0,3,0,3
4589,2017-09-09,Everton,Tottenham,0,3,A,2017-09-09,0,3,3,3,-3,0,0,3,-3
4590,2017-09-09,Leicester,Chelsea,1,2,A,2017-09-09,1,2,2,2,-1,0,0,3,-3
4591,2017-09-09,Man City,Liverpool,5,0,H,2017-09-09,5,0,0,0,5,0,3,0,3
4592,2017-09-09,Southampton,Watford,0,2,A,2017-09-09,0,2,2,2,-2,0,0,3,-3
4593,2017-09-09,Stoke,Man United,2,2,D,2017-09-09,2,2,2,2,0,0,1,1,0
4594,2017-09-10,Burnley,Crystal Palace,1,0,H,2017-09-16,2,0,1,1,1,-1,3,0,3
4595,2017-09-10,Swansea,Newcastle,0,1,A,2017-09-16,0,3,1,1,-1,2,0,3,-3
4596,2017-09-11,West Ham,Huddersfield,2,0,H,2017-09-16,2,1,0,0,2,1,3,0,3
4597,2017-09-15,Bournemouth,Brighton,2,1,H,2017-09-16,2,1,1,1,1,0,3,0,3
4598,2017-09-16,Crystal Palace,Southampton,0,1,A,2017-09-16,0,1,2,2,-2,-1,0,3,-3
4599,2017-09-16,Huddersfield,Leicester,1,1,D,2017-09-16,1,1,3,3,-2,-2,1,1,0
4600,2017-09-16,Liverpool,Burnley,1,1,D,2017-09-16,1,2,1,1,0,1,1,1,0
4601,2017-09-16,Newcastle,Stoke,2,1,H,2017-09-16,3,1,1,1,2,0,3,0,3
4602,2017-09-16,Tottenham,Swansea,0,0,D,2017-09-16,0,0,0,0,0,0,1,1,0
4603,2017-09-16,Watford,Man City,0,6,A,2017-09-16,0,6,6,6,-6,0,0,3,-3
4604,2017-09-16,West Brom,West Ham,0,0,D,2017-09-16,0,2,0,0,0,2,1,1,0
4605,2017-09-17,Chelsea,Arsenal,0,0,D,2017-09-23,4,0,0,0,4,0,1,1,0
4606,2017-09-17,Man United,Everton,4,0,H,2017-09-23,5,2,0,0,5,2,3,0,3
4607,2017-09-23,Burnley,Huddersfield,0,0,D,2017-09-23,0,0,0,0,0,0,1,1,0
4608,2017-09-23,Everton,Bournemouth,2,1,H,2017-09-23,2,1,5,5,-3,-4,3,0,3
4609,2017-09-23,Leicester,Liverpool,2,3,A,2017-09-23,2,3,3,3,-1,0,0,3,-3
4610,2017-09-23,Man City,Crystal Palace,5,0,H,2017-09-23,5,0,0,0,5,0,3,0,3
4611,2017-09-23,Southampton,Man United,0,1,A,2017-09-23,0,5,1,1,-1,4,0,3,-3
4612,2017-09-23,Stoke,Chelsea,0,4,A,2017-09-23,0,4,4,4,-4,0,0,3,-3
4613,2017-09-23,Swansea,Watford,1,2,A,2017-09-23,1,2,2,2,-1,0,0,3,-3
4614,2017-09-23,West Ham,Tottenham,2,3,A,2017-09-23,2,3,3,3,-1,0,0,3,-3
4615,2017-09-24,Brighton,Newcastle,1,0,H,2017-09-30,1,0,0,0,1,0,3,0,3
4616,2017-09-25,Arsenal,West Brom,2,0,H,2017-09-30,2,2,0,0,2,2,3,0,3
4617,2017-09-30,Bournemouth,Leicester,0,0,D,2017-09-30,0,0,0,0,0,0,1,1,0
4618,2017-09-30,Chelsea,Man City,0,1,A,2017-09-30,0,1,1,1,-1,0,0,3,-3
4619,2017-09-30,Huddersfield,Tottenham,0,4,A,2017-09-30,0,4,4,4,-4,0,0,3,-3
4620,2017-09-30,Man United,Crystal Palace,4,0,H,2017-09-30,4,0,0,0,4,0,3,0,3
4621,2017-09-30,Stoke,Southampton,2,1,H,2017-09-30,2,1,1,1,1,0,3,0,3
4622,2017-09-30,West Brom,Watford,2,2,D,2017-09-30,2,2,4,4,-2,-2,1,1,0
4623,2017-09-30,West Ham,Swansea,1,0,H,2017-09-30,1,0,0,0,1,0,3,0,3
4624,2017-10-01,Arsenal,Brighton,2,0,H,2017-10-07,2,0,0,0,2,0,3,0,3
4625,2017-10-01,Everton,Burnley,0,1,A,2017-10-07,0,1,1,1,-1,0,0,3,-3
4626,2017-10-01,Newcastle,Liverpool,1,1,D,2017-10-07,1,1,1,1,0,0,1,1,0
4627,2017-10-14,Burnley,West Ham,1,1,D,2017-10-14,1,1,1,1,0,0,1,1,0
4628,2017-10-14,Crystal Palace,Chelsea,2,1,H,2017-10-14,2,1,1,1,1,0,3,0,3
4629,2017-10-14,Liverpool,Man United,0,0,D,2017-10-14,0,0,0,0,0,0,1,1,0
4630,2017-10-14,Man City,Stoke,7,2,H,2017-10-14,7,2,2,2,5,0,3,0,3
4631,2017-10-14,Swansea,Huddersfield,2,0,H,2017-10-14,2,0,0,0,2,0,3,0,3
4632,2017-10-14,Tottenham,Bournemouth,1,0,H,2017-10-14,1,0,0,0,1,0,3,0,3
4633,2017-10-14,Watford,Arsenal,2,1,H,2017-10-14,2,1,1,1,1,0,3,0,3
4634,2017-10-15,Brighton,Everton,1,1,D,2017-10-21,4,1,1,1,3,0,1,1,0
4635,2017-10-15,Southampton,Newcastle,2,2,D,2017-10-21,3,3,2,2,1,1,4,1,3
4636,2017-10-16,Leicester,West Brom,1,1,D,2017-10-21,3,1,2,2,1,-1,1,1,0
4637,2017-10-20,West Ham,Brighton,0,3,A,2017-10-21,0,4,3,3,-3,1,0,3,-3
4638,2017-10-21,Chelsea,Watford,4,2,H,2017-10-21,4,2,2,2,2,0,3,0,3
4639,2017-10-21,Huddersfield,Man United,2,1,H,2017-10-21,2,1,1,1,1,0,3,0,3
4640,2017-10-21,Man City,Burnley,3,0,H,2017-10-21,3,0,0,0,3,0,3,0,3
4641,2017-10-21,Newcastle,Crystal Palace,1,0,H,2017-10-21,3,0,2,2,1,-2,3,0,3
4642,2017-10-21,Southampton,West Brom,1,0,H,2017-10-21,3,1,2,2,1,-1,4,1,3
4643,2017-10-21,Stoke,Bournemouth,1,2,A,2017-10-21,1,2,2,2,-1,0,0,3,-3
4644,2017-10-21,Swansea,Leicester,1,2,A,2017-10-21,1,3,2,2,-1,1,0,3,-3
4645,2017-10-22,Everton,Arsenal,2,5,A,2017-10-28,2,7,5,5,-3,2,0,3,-3
4646,2017-10-22,Tottenham,Liverpool,4,1,H,2017-10-28,4,4,2,2,2,2,3,0,3
4647,2017-10-28,Arsenal,Swansea,2,1,H,2017-10-28,7,1,3,3,4,-2,3,0,3
4648,2017-10-28,Bournemouth,Chelsea,0,1,A,2017-10-28,0,1,1,1,-1,0,0,3,-3
4649,2017-10-28,Crystal Palace,West Ham,2,2,D,2017-10-28,2,2,2,2,0,0,1,1,0
4650,2017-10-28,Liverpool,Huddersfield,3,0,H,2017-10-28,4,0,4,4,0,-4,3,0,3
4651,2017-10-28,Man United,Tottenham,1,0,H,2017-10-28,1,4,0,0,1,4,3,0,3
4652,2017-10-28,Watford,Stoke,0,1,A,2017-10-28,0,1,1,1,-1,0,0,3,-3
4653,2017-10-28,West Brom,Man City,2,3,A,2017-10-28,2,3,3,3,-1,0,0,3,-3
4654,2017-10-29,Brighton,Southampton,1,1,D,2017-11-04,2,1,1,1,1,0,1,1,0
4655,2017-10-29,Leicester,Everton,2,0,H,2017-11-04,4,0,2,2,2,-2,3,0,3
4656,2017-10-30,Burnley,Newcastle,1,0,H,2017-11-04,2,0,0,0,2,0,3,0,3
4657,2017-11-04,Huddersfield,West Brom,1,0,H,2017-11-04,1,0,0,0,1,0,3,0,3
4658,2017-11-04,Newcastle,Bournemouth,0,1,A,2017-11-04,0,1,2,2,-2,-1,0,3,-3
4659,2017-11-04,Southampton,Burnley,0,1,A,2017-11-04,1,2,2,2,-1,0,0,3,-3
4660,2017-11-04,Stoke,Leicester,2,2,D,2017-11-04,2,4,2,2,0,2,1,1,0
4661,2017-11-04,Swansea,Brighton,0,1,A,2017-11-04,0,2,1,1,-1,1,0,3,-3
4662,2017-11-04,West Ham,Liverpool,1,4,A,2017-11-04,1,4,4,4,-3,0,0,3,-3
4663,2017-11-05,Chelsea,Man United,1,0,H,2017-11-11,1,0,0,0,1,0,3,0,3
4664,2017-11-05,Everton,Watford,3,2,H,2017-11-11,3,2,2,2,1,0,3,0,3
4665,2017-11-05,Man City,Arsenal,3,1,H,2017-11-11,3,1,1,1,2,0,3,0,3
4666,2017-11-05,Tottenham,Crystal Palace,1,0,H,2017-11-11,1,0,0,0,1,0,3,0,3
4667,2017-11-18,Arsenal,Tottenham,2,0,H,2017-11-18,2,0,0,0,2,0,3,0,3
4668,2017-11-18,Bournemouth,Huddersfield,4,0,H,2017-11-18,4,0,0,0,4,0,3,0,3
4669,2017-11-18,Burnley,Swansea,2,0,H,2017-11-18,2,0,0,0,2,0,3,0,3
4670,2017-11-18,Crystal Palace,Everton,2,2,D,2017-11-18,2,2,2,2,0,0,1,1,0
4671,2017-11-18,Leicester,Man City,0,2,A,2017-11-18,0,2,2,2,-2,0,0,3,-3
4672,2017-11-18,Liverpool,Southampton,3,0,H,2017-11-18,3,0,0,0,3,0,3,0,3
4673,2017-11-18,Man United,Newcastle,4,1,H,2017-11-18,4,1,1,1,3,0,3,0,3
4674,2017-11-18,West Brom,Chelsea,0,4,A,2017-11-18,0,4,4,4,-4,0,0,3,-3
4675,2017-11-19,Watford,West Ham,2,0,H,2017-11-25,5,1,0,0,5,1,3,0,3
4676,2017-11-20,Brighton,Stoke,2,2,D,2017-11-25,2,3,3,3,-1,0,1,1,0
4677,2017-11-24,West Ham,Leicester,1,1,D,2017-11-25,1,1,3,3,-2,-2,1,1,0
4678,2017-11-25,Crystal Palace,Stoke,2,1,H,2017-11-25,2,3,1,1,1,2,3,1,2
4679,2017-11-25,Liverpool,Chelsea,1,1,D,2017-11-25,1,1,1,1,0,0,1,1,0
4680,2017-11-25,Man United,Brighton,1,0,H,2017-11-25,1,2,0,0,1,2,3,0,3
4681,2017-11-25,Newcastle,Watford,0,3,A,2017-11-25,0,5,3,3,-3,2,0,3,-3
4682,2017-11-25,Swansea,Bournemouth,0,0,D,2017-11-25,0,0,0,0,0,0,1,1,0
4683,2017-11-25,Tottenham,West Brom,1,1,D,2017-11-25,1,1,1,1,0,0,1,1,0
4684,2017-11-26,Burnley,Arsenal,0,1,A,2017-12-02,2,7,3,3,-1,4,0,3,-3
4685,2017-11-26,Huddersfield,Man City,1,2,A,2017-12-02,1,4,9,9,-8,-5,0,3,-3
4686,2017-11-26,Southampton,Everton,4,1,H,2017-12-02,5,7,3,3,2,4,3,0,3
4687,2017-11-28,Brighton,Crystal Palace,0,0,D,2017-12-02,1,0,5,5,-4,-5,1,2,-1
4688,2017-11-28,Leicester,Tottenham,2,1,H,2017-12-02,3,2,1,1,2,1,6,1,5
4689,2017-11-28,Watford,Man United,2,4,A,2017-12-02,3,7,5,5,-2,2,1,6,-5
4690,2017-11-28,West Brom,Newcastle,2,2,D,2017-12-02,2,3,2,2,0,1,2,1,1
4691,2017-11-29,Arsenal,Huddersfield,5,0,H,2017-12-02,7,1,3,3,4,-2,3,0,3
4692,2017-11-29,Bournemouth,Burnley,1,2,A,2017-12-02,1,2,2,2,-1,0,0,3,-3
4693,2017-11-29,Chelsea,Swansea,1,0,H,2017-12-02,4,1,1,1,3,0,6,0,6
4694,2017-11-29,Everton,West Ham,4,0,H,2017-12-02,7,0,4,4,3,-4,6,0,6
4695,2017-11-29,Man City,Southampton,2,1,H,2017-12-02,4,5,2,2,2,3,3,0,3
4696,2017-11-29,Stoke,Liverpool,0,3,A,2017-12-02,2,8,4,4,-2,4,3,6,-3
4697,2017-12-02,Arsenal,Man United,1,3,A,2017-12-02,7,7,3,3,4,4,3,6,-3
4698,2017-12-02,Brighton,Liverpool,1,5,A,2017-12-02,1,8,5,5,-4,3,1,6,-5
4699,2017-12-02,Chelsea,Newcastle,3,1,H,2017-12-02,4,3,1,1,3,2,6,1,5
4700,2017-12-02,Everton,Huddersfield,2,0,H,2017-12-02,7,1,4,4,3,-3,6,0,6
4701,2017-12-02,Leicester,Burnley,1,0,H,2017-12-02,3,2,1,1,2,1,6,3,3
4702,2017-12-02,Stoke,Swansea,2,1,H,2017-12-02,2,1,4,4,-2,-3,3,0,3
4703,2017-12-02,Watford,Tottenham,1,1,D,2017-12-02,3,2,5,5,-2,-3,1,1,0
4704,2017-12-02,West Brom,Crystal Palace,0,0,D,2017-12-02,2,0,2,2,0,-2,2,2,0
4705,2017-12-03,Bournemouth,Southampton,1,1,D,2017-12-09,3,1,3,3,0,-2,1,1,0
4706,2017-12-03,Man City,West Ham,2,1,H,2017-12-09,2,2,1,1,1,1,3,0,3
4707,2017-12-09,Burnley,Watford,1,0,H,2017-12-09,1,0,0,0,1,0,3,0,3
4708,2017-12-09,Crystal Palace,Bournemouth,2,2,D,2017-12-09,2,3,2,2,0,1,1,1,0
4709,2017-12-09,Huddersfield,Brighton,2,0,H,2017-12-09,2,0,0,0,2,0,3,0,3
4710,2017-12-09,Newcastle,Leicester,2,3,A,2017-12-09,2,3,3,3,-1,0,0,3,-3
4711,2017-12-09,Swansea,West Brom,1,0,H,2017-12-09,1,0,0,0,1,0,3,0,3
4712,2017-12-09,Tottenham,Stoke,5,1,H,2017-12-09,5,1,1,1,4,0,3,0,3
4713,2017-12-09,West Ham,Chelsea,1,0,H,2017-12-09,2,0,2,2,0,-2,3,0,3
4714,2017-12-10,Liverpool,Everton,1,1,D,2017-12-16,1,2,1,1,0,1,2,4,-2
4715,2017-12-10,Man United,Man City,1,2,A,2017-12-16,2,10,2,2,0,8,3,6,-3
4716,2017-12-10,Southampton,Arsenal,1,1,D,2017-12-16,2,2,6,6,-4,-4,1,2,-1
4717,2017-12-12,Burnley,Stoke,1,0,H,2017-12-16,1,0,0,0,1,0,3,0,3
4718,2017-12-12,Crystal Palace,Watford,2,1,H,2017-12-16,5,2,1,1,4,1,3,0,3
4719,2017-12-12,Huddersfield,Chelsea,1,3,A,2017-12-16,5,4,4,4,1,0,0,3,-3
4720,2017-12-13,Liverpool,West Brom,0,0,D,2017-12-16,1,0,1,1,0,-1,2,1,1
4721,2017-12-13,Man United,Bournemouth,1,0,H,2017-12-16,2,0,2,2,0,-2,3,0,3
4722,2017-12-13,Newcastle,Everton,0,1,A,2017-12-16,0,2,2,2,-2,0,0,4,-4
4723,2017-12-13,Southampton,Leicester,1,4,A,2017-12-16,2,4,6,6,-4,-2,1,3,-2
4724,2017-12-13,Swansea,Man City,0,4,A,2017-12-16,0,10,4,4,-4,6,0,6,-6
4725,2017-12-13,Tottenham,Brighton,2,0,H,2017-12-16,3,0,4,4,-1,-4,3,0,3
4726,2017-12-13,West Ham,Arsenal,0,0,D,2017-12-16,3,2,0,0,3,2,1,2,-1
4727,2017-12-16,Arsenal,Newcastle,1,0,H,2017-12-16,2,0,1,1,1,-1,3,0,3
4728,2017-12-16,Brighton,Burnley,0,0,D,2017-12-16,0,1,2,2,-2,-1,1,1,0
4729,2017-12-16,Chelsea,Southampton,1,0,H,2017-12-16,4,2,1,1,3,1,3,0,3
4730,2017-12-16,Leicester,Crystal Palace,0,3,A,2017-12-16,4,5,4,4,0,1,0,3,-3
4731,2017-12-16,Man City,Tottenham,4,1,H,2017-12-16,10,3,2,2,8,1,3,0,3
4732,2017-12-16,Stoke,West Ham,0,3,A,2017-12-16,0,3,4,4,-4,-1,0,3,-3
4733,2017-12-16,Watford,Huddersfield,1,4,A,2017-12-16,2,5,6,6,-4,-1,0,3,-3
4734,2017-12-17,Bournemouth,Liverpool,0,4,A,2017-12-23,0,7,8,8,-8,-1,0,4,-4
4735,2017-12-17,West Brom,Man United,1,2,A,2017-12-23,2,4,5,5,-3,-1,0,4,-4
4736,2017-12-18,Everton,Swansea,3,1,H,2017-12-23,3,2,1,1,2,1,4,0,4
4737,2017-12-22,Arsenal,Liverpool,3,3,D,2017-12-23,3,7,3,3,0,4,1,4,-3
4738,2017-12-23,Brighton,Watford,1,0,H,2017-12-23,1,0,0,0,1,0,3,0,3
4739,2017-12-23,Burnley,Tottenham,0,3,A,2017-12-23,0,3,3,3,-3,0,0,3,-3
4740,2017-12-23,Everton,Chelsea,0,0,D,2017-12-23,3,0,1,1,2,-1,4,1,3
4741,2017-12-23,Leicester,Man United,2,2,D,2017-12-23,2,4,2,2,0,2,1,4,-3
4742,2017-12-23,Man City,Bournemouth,4,0,H,2017-12-23,4,0,0,0,4,0,3,0,3
4743,2017-12-23,Southampton,Huddersfield,1,1,D,2017-12-23,1,1,1,1,0,0,1,1,0
4744,2017-12-23,Stoke,West Brom,3,1,H,2017-12-23,3,2,1,1,2,1,3,0,3
4745,2017-12-23,Swansea,Crystal Palace,1,1,D,2017-12-23,2,1,4,4,-2,-3,1,1,0
4746,2017-12-23,West Ham,Newcastle,2,3,A,2017-12-23,2,3,3,3,-1,0,0,3,-3
4747,2017-12-26,Bournemouth,West Ham,3,3,D,2017-12-30,5,3,4,4,1,-1,4,1,3
4748,2017-12-26,Chelsea,Brighton,2,0,H,2017-12-30,7,0,0,0,7,0,6,1,5
4749,2017-12-26,Huddersfield,Stoke,1,1,D,2017-12-30,1,1,1,1,0,0,2,1,1
4750,2017-12-26,Liverpool,Swansea,5,0,H,2017-12-30,7,2,1,1,6,1,6,3,3
4751,2017-12-26,Man United,Burnley,2,2,D,2017-12-30,2,2,2,2,0,0,2,2,0
4752,2017-12-26,Tottenham,Southampton,5,2,H,2017-12-30,5,2,2,2,3,0,3,1,2
4753,2017-12-26,Watford,Leicester,2,1,H,2017-12-30,3,2,3,3,0,-1,3,0,3
4754,2017-12-26,West Brom,Everton,0,0,D,2017-12-30,0,1,0,0,0,1,1,1,0
4755,2017-12-27,Newcastle,Man City,0,1,A,2017-12-30,0,1,1,1,-1,0,1,3,-2
4756,2017-12-28,Crystal Palace,Arsenal,2,3,A,2017-12-30,2,3,3,3,-1,0,0,3,-3
4757,2017-12-30,Bournemouth,Everton,2,1,H,2017-12-30,5,1,4,4,1,-3,4,1,3
4758,2017-12-30,Chelsea,Stoke,5,0,H,2017-12-30,7,1,0,0,7,1,6,1,5
4759,2017-12-30,Huddersfield,Burnley,0,0,D,2017-12-30,1,2,1,1,0,1,2,2,0
4760,2017-12-30,Liverpool,Leicester,2,1,H,2017-12-30,7,2,1,1,6,1,6,0,6
4761,2017-12-30,Man United,Southampton,0,0,D,2017-12-30,2,2,2,2,0,0,2,1,1
4762,2017-12-30,Newcastle,Brighton,0,0,D,2017-12-30,0,0,1,1,-1,-1,1,1,0
4763,2017-12-30,Watford,Swansea,1,2,A,2017-12-30,3,2,3,3,0,-1,3,3,0
4764,2017-12-31,Crystal Palace,Man City,0,0,D,2018-01-06,2,3,1,1,1,2,1,1,0
4765,2017-12-31,West Brom,Arsenal,1,1,D,2018-01-06,2,3,3,3,-1,0,1,1,0
4766,2018-01-01,Brighton,Bournemouth,2,2,D,2018-01-06,2,2,2,2,0,0,1,1,0
4767,2018-01-01,Burnley,Liverpool,1,2,A,2018-01-06,1,2,2,2,-1,0,0,3,-3
4768,2018-01-01,Everton,Man United,0,2,A,2018-01-06,0,2,2,2,-2,0,0,3,-3
4769,2018-01-01,Leicester,Huddersfield,3,0,H,2018-01-06,3,0,0,0,3,0,3,0,3
4770,2018-01-01,Stoke,Newcastle,0,1,A,2018-01-06,0,1,1,1,-1,0,0,3,-3
4771,2018-01-02,Man City,Watford,3,1,H,2018-01-06,3,1,1,1,2,0,3,0,3
4772,2018-01-02,Southampton,Crystal Palace,1,2,A,2018-01-06,1,2,2,2,-1,0,0,3,-3
4773,2018-01-02,Swansea,Tottenham,0,2,A,2018-01-06,0,3,2,2,-2,1,0,3,-3
4774,2018-01-02,West Ham,West Brom,2,1,H,2018-01-06,3,2,2,2,1,0,3,0,3
4775,2018-01-03,Arsenal,Chelsea,2,2,D,2018-01-06,3,2,3,3,0,-1,1,1,0
4776,2018-01-04,Tottenham,West Ham,1,1,D,2018-01-06,3,3,1,1,2,2,1,1,0
4777,2018-01-13,Chelsea,Leicester,0,0,D,2018-01-13,0,0,0,0,0,0,1,1,0
4778,2018-01-13,Crystal Palace,Burnley,1,0,H,2018-01-13,1,0,0,0,1,0,3,0,3
4779,2018-01-13,Huddersfield,West Ham,1,4,A,2018-01-13,1,4,4,4,-3,0,0,3,-3
4780,2018-01-13,Newcastle,Swansea,1,1,D,2018-01-13,1,1,1,1,0,0,1,1,0
4781,2018-01-13,Tottenham,Everton,4,0,H,2018-01-13,4,0,0,0,4,0,3,0,3
4782,2018-01-13,Watford,Southampton,2,2,D,2018-01-13,2,2,2,2,0,0,1,1,0
4783,2018-01-13,West Brom,Brighton,2,0,H,2018-01-13,2,0,0,0,2,0,3,0,3
4784,2018-01-14,Bournemouth,Arsenal,2,1,H,2018-01-20,3,5,2,2,1,3,3,0,3
4785,2018-01-14,Liverpool,Man City,4,3,H,2018-01-20,4,6,3,3,1,3,3,0,3
4786,2018-01-15,Man United,Stoke,3,0,H,2018-01-20,4,2,0,0,4,2,3,0,3
4787,2018-01-20,Arsenal,Crystal Palace,4,1,H,2018-01-20,5,1,3,3,2,-2,3,0,3
4788,2018-01-20,Brighton,Chelsea,0,4,A,2018-01-20,0,4,4,4,-4,0,0,3,-3
4789,2018-01-20,Burnley,Man United,0,1,A,2018-01-20,0,4,1,1,-1,3,0,3,-3
4790,2018-01-20,Everton,West Brom,1,1,D,2018-01-20,1,1,1,1,0,0,1,1,0
4791,2018-01-20,Leicester,Watford,2,0,H,2018-01-20,2,0,0,0,2,0,3,0,3
4792,2018-01-20,Man City,Newcastle,3,1,H,2018-01-20,6,1,5,5,1,-4,3,0,3
4793,2018-01-20,Stoke,Huddersfield,2,0,H,2018-01-20,2,0,3,3,-1,-3,3,0,3
4794,2018-01-20,West Ham,Bournemouth,1,1,D,2018-01-20,1,3,1,1,0,2,1,1,0
4795,2018-01-21,Southampton,Tottenham,1,1,D,2018-01-27,1,1,1,1,0,0,1,1,0
4796,2018-01-22,Swansea,Liverpool,1,0,H,2018-01-27,1,0,0,0,1,0,3,0,3
4797,2018-01-30,Huddersfield,Liverpool,0,3,A,2018-02-03,0,3,5,5,-5,-2,0,3,-3
4798,2018-01-30,Swansea,Arsenal,3,1,H,2018-02-03,4,6,2,2,2,4,3,0,3
4799,2018-01-30,West Ham,Crystal Palace,1,1,D,2018-02-03,2,1,4,4,-2,-3,1,1,0
4800,2018-01-31,Chelsea,Bournemouth,0,3,A,2018-02-03,0,5,3,3,-3,2,0,3,-3
4801,2018-01-31,Everton,Leicester,2,1,H,2018-02-03,3,2,6,6,-3,-4,3,0,3
4802,2018-01-31,Man City,West Brom,3,0,H,2018-02-03,4,2,1,1,3,1,3,0,3
4803,2018-01-31,Newcastle,Burnley,1,1,D,2018-02-03,1,2,1,1,0,1,1,1,0
4804,2018-01-31,Southampton,Brighton,1,1,D,2018-02-03,4,4,3,3,1,1,1,1,0
4805,2018-01-31,Stoke,Watford,0,0,D,2018-02-03,1,0,2,2,-1,-2,1,1,0
4806,2018-01-31,Tottenham,Man United,2,0,H,2018-02-03,2,2,0,0,2,2,3,0,3
4807,2018-02-03,Arsenal,Everton,5,1,H,2018-02-03,6,3,4,4,2,-1,3,0,3
4808,2018-02-03,Bournemouth,Stoke,2,1,H,2018-02-03,5,1,1,1,4,0,3,0,3
4809,2018-02-03,Brighton,West Ham,3,1,H,2018-02-03,4,2,2,2,2,0,3,0,3
4810,2018-02-03,Burnley,Man City,1,1,D,2018-02-03,2,4,2,2,0,2,1,1,0
4811,2018-02-03,Leicester,Swansea,1,1,D,2018-02-03,2,4,3,3,-1,1,1,1,0
4812,2018-02-03,Man United,Huddersfield,2,0,H,2018-02-03,2,0,2,2,0,-2,3,0,3
4813,2018-02-03,West Brom,Southampton,2,3,A,2018-02-03,2,4,6,6,-4,-2,0,3,-3
4814,2018-02-04,Crystal Palace,Newcastle,1,1,D,2018-02-10,2,1,4,4,-2,-3,1,1,0
4815,2018-02-04,Liverpool,Tottenham,2,2,D,2018-02-10,2,3,2,2,0,1,1,1,0
4816,2018-02-05,Watford,Chelsea,4,1,H,2018-02-10,4,1,3,3,1,-2,3,0,3
4817,2018-02-10,Everton,Crystal Palace,3,1,H,2018-02-10,3,2,1,1,2,1,3,0,3
4818,2018-02-10,Man City,Leicester,5,1,H,2018-02-10,5,1,1,1,4,0,3,0,3
4819,2018-02-10,Stoke,Brighton,1,1,D,2018-02-10,1,1,1,1,0,0,1,1,0
4820,2018-02-10,Swansea,Burnley,1,0,H,2018-02-10,1,0,0,0,1,0,3,0,3
4821,2018-02-10,Tottenham,Arsenal,1,0,H,2018-02-10,3,0,2,2,1,-2,3,0,3
4822,2018-02-10,West Ham,Watford,2,0,H,2018-02-10,2,4,0,0,2,4,3,0,3
4823,2018-02-11,Huddersfield,Bournemouth,4,1,H,2018-02-17,4,1,1,1,3,0,3,0,3
4824,2018-02-11,Newcastle,Man United,1,0,H,2018-02-17,1,0,0,0,1,0,3,0,3
4825,2018-02-11,Southampton,Liverpool,0,2,A,2018-02-17,0,2,2,2,-2,0,0,3,-3
4826,2018-02-12,Chelsea,West Brom,3,0,H,2018-02-17,3,0,0,0,3,0,3,0,3
4827,2018-02-24,Bournemouth,Newcastle,2,2,D,2018-02-24,2,2,2,2,0,0,1,1,0
4828,2018-02-24,Brighton,Swansea,4,1,H,2018-02-24,4,1,1,1,3,0,3,0,3
4829,2018-02-24,Burnley,Southampton,1,1,D,2018-02-24,1,1,1,1,0,0,1,1,0
4830,2018-02-24,Leicester,Stoke,1,1,D,2018-02-24,1,1,1,1,0,0,1,1,0
4831,2018-02-24,Liverpool,West Ham,4,1,H,2018-02-24,4,1,1,1,3,0,3,0,3
4832,2018-02-24,Watford,Everton,1,0,H,2018-02-24,1,0,0,0,1,0,3,0,3
4833,2018-02-24,West Brom,Huddersfield,1,2,A,2018-02-24,1,2,2,2,-1,0,0,3,-3
4834,2018-02-25,Crystal Palace,Tottenham,0,1,A,2018-03-03,0,3,1,1,-1,2,0,3,-3
4835,2018-02-25,Man United,Chelsea,2,1,H,2018-03-03,2,1,1,1,1,0,3,0,3
4836,2018-03-01,Arsenal,Man City,0,3,A,2018-03-03,0,3,3,3,-3,0,0,3,-3
4837,2018-03-03,Burnley,Everton,2,1,H,2018-03-03,2,1,1,1,1,0,3,0,3
4838,2018-03-03,Leicester,Bournemouth,1,1,D,2018-03-03,1,1,1,1,0,0,1,1,0
4839,2018-03-03,Liverpool,Newcastle,2,0,H,2018-03-03,2,0,0,0,2,0,3,0,3
4840,2018-03-03,Southampton,Stoke,0,0,D,2018-03-03,0,0,0,0,0,0,1,1,0
4841,2018-03-03,Swansea,West Ham,4,1,H,2018-03-03,4,1,1,1,3,0,3,0,3
4842,2018-03-03,Tottenham,Huddersfield,2,0,H,2018-03-03,3,0,0,0,3,0,3,0,3
4843,2018-03-03,Watford,West Brom,1,0,H,2018-03-03,1,0,0,0,1,0,3,0,3
4844,2018-03-04,Brighton,Arsenal,2,1,H,2018-03-10,2,1,3,3,-1,-2,3,0,3
4845,2018-03-04,Man City,Chelsea,1,0,H,2018-03-10,1,2,0,0,1,2,3,0,3
4846,2018-03-05,Crystal Palace,Man United,2,3,A,2018-03-10,3,5,5,5,-2,0,0,3,-3
4847,2018-03-10,Chelsea,Crystal Palace,2,1,H,2018-03-10,2,3,2,2,0,1,3,0,3
4848,2018-03-10,Everton,Brighton,2,0,H,2018-03-10,2,2,0,0,2,2,3,0,3
4849,2018-03-10,Huddersfield,Swansea,0,0,D,2018-03-10,0,0,0,0,0,0,1,1,0
4850,2018-03-10,Man United,Liverpool,2,1,H,2018-03-10,5,1,3,3,2,-2,3,0,3
4851,2018-03-10,Newcastle,Southampton,3,0,H,2018-03-10,3,0,0,0,3,0,3,0,3
4852,2018-03-10,West Brom,Leicester,1,4,A,2018-03-10,1,4,4,4,-3,0,0,3,-3
4853,2018-03-10,West Ham,Burnley,0,3,A,2018-03-10,0,3,3,3,-3,0,0,3,-3
4854,2018-03-11,Arsenal,Watford,3,0,H,2018-03-17,3,0,0,0,3,0,3,0,3
4855,2018-03-11,Bournemouth,Tottenham,1,4,A,2018-03-17,3,4,5,5,-2,-1,3,3,0
4856,2018-03-12,Stoke,Man City,0,2,A,2018-03-17,1,2,4,4,-3,-2,0,3,-3
4857,2018-03-17,Bournemouth,West Brom,2,1,H,2018-03-17,3,1,5,5,-2,-4,3,0,3
4858,2018-03-17,Huddersfield,Crystal Palace,0,2,A,2018-03-17,0,2,2,2,-2,0,0,3,-3
4859,2018-03-17,Liverpool,Watford,5,0,H,2018-03-17,5,0,0,0,5,0,3,0,3
4860,2018-03-17,Stoke,Everton,1,2,A,2018-03-17,1,2,4,4,-3,-2,0,3,-3
4861,2018-03-31,Brighton,Leicester,0,2,A,2018-03-31,0,2,2,2,-2,0,0,3,-3
4862,2018-03-31,Crystal Palace,Liverpool,1,2,A,2018-03-31,1,2,2,2,-1,0,0,3,-3
4863,2018-03-31,Everton,Man City,1,3,A,2018-03-31,1,3,3,3,-2,0,0,3,-3
4864,2018-03-31,Man United,Swansea,2,0,H,2018-03-31,2,0,0,0,2,0,3,0,3
4865,2018-03-31,Newcastle,Huddersfield,1,0,H,2018-03-31,1,0,0,0,1,0,3,0,3
4866,2018-03-31,Watford,Bournemouth,2,2,D,2018-03-31,2,2,2,2,0,0,1,1,0
4867,2018-03-31,West Brom,Burnley,1,2,A,2018-03-31,1,2,2,2,-1,0,0,3,-3
4868,2018-03-31,West Ham,Southampton,3,0,H,2018-03-31,3,0,0,0,3,0,3,0,3
4869,2018-04-01,Arsenal,Stoke,3,0,H,2018-04-07,3,1,0,0,3,1,3,0,3
4870,2018-04-01,Chelsea,Tottenham,1,3,A,2018-04-07,1,5,3,3,-2,2,0,6,-6
4871,2018-04-07,Bournemouth,Crystal Palace,2,2,D,2018-04-07,2,2,2,2,0,0,1,1,0
4872,2018-04-07,Brighton,Huddersfield,1,1,D,2018-04-07,1,1,1,1,0,0,1,1,0
4873,2018-04-07,Everton,Liverpool,0,0,D,2018-04-07,0,0,0,0,0,0,1,1,0
4874,2018-04-07,Leicester,Newcastle,1,2,A,2018-04-07,1,2,2,2,-1,0,0,3,-3
4875,2018-04-07,Man City,Man United,2,3,A,2018-04-07,2,3,3,3,-1,0,0,3,-3
4876,2018-04-07,Stoke,Tottenham,1,2,A,2018-04-07,1,5,5,5,-4,0,0,6,-6
4877,2018-04-07,Watford,Burnley,1,2,A,2018-04-07,1,2,2,2,-1,0,0,3,-3
4878,2018-04-07,West Brom,Swansea,1,1,D,2018-04-07,1,1,1,1,0,0,1,1,0
4879,2018-04-08,Arsenal,Southampton,3,2,H,2018-04-14,3,4,2,2,1,2,3,0,3
4880,2018-04-08,Chelsea,West Ham,1,1,D,2018-04-14,4,1,3,3,1,-2,1,1,0
4881,2018-04-14,Burnley,Leicester,2,1,H,2018-04-14,2,1,1,1,1,0,3,0,3
4882,2018-04-14,Crystal Palace,Brighton,3,2,H,2018-04-14,3,2,2,2,1,0,3,0,3
4883,2018-04-14,Huddersfield,Watford,1,0,H,2018-04-14,1,0,0,0,1,0,3,0,3
4884,2018-04-14,Liverpool,Bournemouth,3,0,H,2018-04-14,3,0,0,0,3,0,3,0,3
4885,2018-04-14,Southampton,Chelsea,2,3,A,2018-04-14,4,4,6,6,-2,-2,0,3,-3
4886,2018-04-14,Swansea,Everton,1,1,D,2018-04-14,1,1,1,1,0,0,1,1,0
4887,2018-04-14,Tottenham,Man City,1,3,A,2018-04-14,1,3,3,3,-2,0,0,3,-3
4888,2018-04-15,Man United,West Brom,0,1,A,2018-04-21,2,3,1,1,1,2,0,3,-3
4889,2018-04-15,Newcastle,Arsenal,2,1,H,2018-04-21,2,1,1,1,1,0,3,0,3
4890,2018-04-16,West Ham,Stoke,1,1,D,2018-04-21,1,1,1,1,0,0,1,1,0
4891,2018-04-17,Brighton,Tottenham,1,1,D,2018-04-21,1,1,1,1,0,0,1,1,0
4892,2018-04-18,Bournemouth,Man United,0,2,A,2018-04-21,0,2,2,2,-2,0,0,3,-3
4893,2018-04-19,Burnley,Chelsea,1,2,A,2018-04-21,1,2,2,2,-1,0,0,3,-3
4894,2018-04-19,Leicester,Southampton,0,0,D,2018-04-21,0,0,0,0,0,0,1,1,0
4895,2018-04-21,Watford,Crystal Palace,0,0,D,2018-04-21,0,0,0,0,0,0,1,1,0
4896,2018-04-21,West Brom,Liverpool,2,2,D,2018-04-21,3,2,2,2,1,0,1,1,0
4897,2018-04-22,Arsenal,West Ham,4,1,H,2018-04-28,4,1,1,1,3,0,3,0,3
4898,2018-04-22,Man City,Swansea,5,0,H,2018-04-28,5,0,0,0,5,0,3,0,3
4899,2018-04-22,Stoke,Burnley,1,1,D,2018-04-28,1,1,1,1,0,0,1,1,0
4900,2018-04-23,Everton,Newcastle,1,0,H,2018-04-28,3,0,0,0,3,0,3,0,3
4901,2018-04-28,Burnley,Brighton,0,0,D,2018-04-28,1,0,1,1,0,-1,1,1,0
4902,2018-04-28,Crystal Palace,Leicester,5,0,H,2018-04-28,5,0,0,0,5,0,3,0,3
4903,2018-04-28,Huddersfield,Everton,0,2,A,2018-04-28,0,3,2,2,-2,1,0,3,-3
4904,2018-04-28,Liverpool,Stoke,0,0,D,2018-04-28,0,1,0,0,0,1,1,1,0
4905,2018-04-28,Newcastle,West Brom,0,1,A,2018-04-28,0,1,2,2,-2,-1,0,3,-3
4906,2018-04-28,Southampton,Bournemouth,2,1,H,2018-04-28,2,1,1,1,1,0,3,0,3
4907,2018-04-28,Swansea,Chelsea,0,1,A,2018-04-28,0,1,6,6,-6,-5,0,3,-3
4908,2018-04-29,Man United,Arsenal,2,1,H,2018-05-05,2,1,2,2,0,-1,3,0,3
4909,2018-04-29,West Ham,Man City,1,4,A,2018-05-05,3,4,4,4,-1,0,0,3,-3
4910,2018-04-30,Tottenham,Watford,2,0,H,2018-05-05,2,2,1,1,1,1,3,0,3
4911,2018-05-04,Brighton,Man United,1,0,H,2018-05-05,1,2,0,0,1,2,3,0,3
4912,2018-05-05,Bournemouth,Swansea,1,0,H,2018-05-05,1,0,0,0,1,0,3,0,3
4913,2018-05-05,Everton,Southampton,1,1,D,2018-05-05,1,1,1,1,0,0,1,1,0
4914,2018-05-05,Leicester,West Ham,0,2,A,2018-05-05,0,3,2,2,-2,1,0,3,-3
4915,2018-05-05,Stoke,Crystal Palace,1,2,A,2018-05-05,1,2,2,2,-1,0,0,3,-3
4916,2018-05-05,Watford,Newcastle,2,1,H,2018-05-05,2,1,3,3,-1,-2,3,0,3
4917,2018-05-05,West Brom,Tottenham,1,0,H,2018-05-05,1,2,0,0,1,2,3,0,3
4918,2018-05-06,Arsenal,Burnley,5,0,H,2018-05-12,6,0,3,3,3,-3,3,0,3
4919,2018-05-06,Chelsea,Liverpool,1,0,H,2018-05-12,2,0,1,1,1,-1,4,0,4
4920,2018-05-06,Man City,Huddersfield,0,0,D,2018-05-12,3,1,1,1,2,0,4,2,2
4921,2018-05-08,Swansea,Southampton,0,1,A,2018-05-12,0,1,1,1,-1,0,0,3,-3
4922,2018-05-09,Chelsea,Huddersfield,1,1,D,2018-05-12,2,1,1,1,1,0,4,2,2
4923,2018-05-09,Leicester,Arsenal,3,1,H,2018-05-12,3,6,1,1,2,5,3,0,3
4924,2018-05-09,Man City,Brighton,3,1,H,2018-05-12,3,1,1,1,2,0,4,0,4
4925,2018-05-09,Tottenham,Newcastle,1,0,H,2018-05-12,1,0,0,0,1,0,3,0,3
4926,2018-05-10,West Ham,Man United,0,0,D,2018-05-12,0,0,0,0,0,0,1,1,0
4927,2018-05-13,Burnley,Bournemouth,1,2,A,2018-05-19,1,2,2,2,-1,0,0,3,-3
4928,2018-05-13,Crystal Palace,West Brom,2,0,H,2018-05-19,2,0,0,0,2,0,3,0,3
4929,2018-05-13,Huddersfield,Arsenal,0,1,A,2018-05-19,0,1,1,1,-1,0,0,3,-3
4930,2018-05-13,Liverpool,Brighton,4,0,H,2018-05-19,4,0,0,0,4,0,3,0,3
4931,2018-05-13,Man United,Watford,1,0,H,2018-05-19,1,0,0,0,1,0,3,0,3
4932,2018-05-13,Newcastle,Chelsea,3,0,H,2018-05-19,3,0,0,0,3,0,3,0,3
4933,2018-05-13,Southampton,Man City,0,1,A,2018-05-19,0,1,1,1,-1,0,0,3,-3
4934,2018-05-13,Swansea,Stoke,1,2,A,2018-05-19,1,2,2,2,-1,0,0,3,-3
4935,2018-05-13,Tottenham,Leicester,5,4,H,2018-05-19,5,4,4,4,1,0,3,0,3
4936,2018-05-13,West Ham,Everton,3,1,H,2018-05-19,3,1,1,1,2,0,3,0,3
4937,2018-08-10,Man United,Leicester,2,1,H,2018-08-11,2,1,1,1,1,0,3,0,3
4938,2018-08-11,Bournemouth,Cardiff,2,0,H,2018-08-11,2,0,0,0,2,0,3,0,3
4939,2018-08-11,Fulham,Crystal Palace,0,2,A,2018-08-11,0,2,2,2,-2,0,0,3,-3
4940,2018-08-11,Huddersfield,Chelsea,0,3,A,2018-08-11,0,3,3,3,-3,0,0,3,-3
4941,2018-08-11,Newcastle,Tottenham,1,2,A,2018-08-11,1,2,2,2,-1,0,0,3,-3
4942,2018-08-11,Watford,Brighton,2,0,H,2018-08-11,2,0,0,0,2,0,3,0,3
4943,2018-08-11,Wolves,Everton,2,2,D,2018-08-11,2,2,2,2,0,0,1,1,0
4944,2018-08-12,Arsenal,Man City,0,2,A,2018-08-18,2,2,5,5,-3,-3,0,3,-3
4945,2018-08-12,Liverpool,West Ham,4,0,H,2018-08-18,4,1,0,0,4,1,3,0,3
4946,2018-08-12,Southampton,Burnley,0,0,D,2018-08-18,1,0,2,2,-1,-2,1,1,0
4947,2018-08-18,Cardiff,Newcastle,0,0,D,2018-08-18,0,0,0,0,0,0,1,1,0
4948,2018-08-18,Chelsea,Arsenal,3,2,H,2018-08-18,3,2,2,2,1,0,3,0,3
4949,2018-08-18,Everton,Southampton,2,1,H,2018-08-18,2,1,1,1,1,0,3,0,3
4950,2018-08-18,Leicester,Wolves,2,0,H,2018-08-18,2,0,0,0,2,0,3,0,3
4951,2018-08-18,Tottenham,Fulham,3,1,H,2018-08-18,3,1,1,1,2,0,3,0,3
4952,2018-08-18,West Ham,Bournemouth,1,2,A,2018-08-18,1,2,6,6,-5,-4,0,3,-3
4953,2018-08-19,Brighton,Man United,3,2,H,2018-08-25,3,2,3,3,0,-1,3,0,3
4954,2018-08-19,Burnley,Watford,1,3,A,2018-08-25,1,3,3,3,-2,0,0,3,-3
4955,2018-08-19,Man City,Huddersfield,6,1,H,2018-08-25,7,1,2,2,5,-1,3,0,3
4956,2018-08-20,Crystal Palace,Liverpool,0,2,A,2018-08-25,0,3,2,2,-2,1,0,3,-3
4957,2018-08-25,Arsenal,West Ham,3,1,H,2018-08-25,3,1,1,1,2,0,3,0,3
4958,2018-08-25,Bournemouth,Everton,2,2,D,2018-08-25,2,2,2,2,0,0,1,1,0
4959,2018-08-25,Huddersfield,Cardiff,0,0,D,2018-08-25,1,0,6,6,-5,-6,1,1,0
4960,2018-08-25,Liverpool,Brighton,1,0,H,2018-08-25,3,3,0,0,3,3,3,0,3
4961,2018-08-25,Southampton,Leicester,1,2,A,2018-08-25,1,2,2,2,-1,0,0,3,-3
4962,2018-08-25,Wolves,Man City,1,1,D,2018-08-25,1,7,1,1,0,6,1,1,0
4963,2018-08-26,Fulham,Burnley,4,2,H,2018-09-01,6,2,4,4,2,-2,3,0,3
4964,2018-08-26,Newcastle,Chelsea,1,2,A,2018-09-01,2,4,4,4,-2,0,0,3,-3
4965,2018-08-26,Watford,Crystal Palace,2,1,H,2018-09-01,2,1,1,1,1,0,3,0,3
4966,2018-08-27,Man United,Tottenham,0,3,A,2018-09-01,0,3,3,3,-3,0,0,3,-3
4967,2018-09-01,Brighton,Fulham,2,2,D,2018-09-01,2,6,2,2,0,4,1,1,0
4968,2018-09-01,Chelsea,Bournemouth,2,0,H,2018-09-01,4,0,1,1,3,-1,3,0,3
4969,2018-09-01,Crystal Palace,Southampton,0,2,A,2018-09-01,1,2,4,4,-3,-2,0,3,-3
4970,2018-09-01,Everton,Huddersfield,1,1,D,2018-09-01,1,1,1,1,0,0,1,1,0
4971,2018-09-01,Leicester,Liverpool,1,2,A,2018-09-01,1,2,2,2,-1,0,0,3,-3
4972,2018-09-01,Man City,Newcastle,2,1,H,2018-09-01,2,2,1,1,1,1,3,0,3
4973,2018-09-01,West Ham,Wolves,0,1,A,2018-09-01,0,1,1,1,-1,0,0,3,-3
4974,2018-09-02,Burnley,Man United,0,2,A,2018-09-08,0,2,2,2,-2,0,0,3,-3
4975,2018-09-02,Cardiff,Arsenal,2,3,A,2018-09-08,2,3,3,3,-1,0,0,3,-3
4976,2018-09-02,Watford,Tottenham,2,1,H,2018-09-08,2,1,1,1,1,0,3,0,3
4977,2018-09-15,Bournemouth,Leicester,4,2,H,2018-09-15,4,2,2,2,2,0,3,0,3
4978,2018-09-15,Chelsea,Cardiff,4,1,H,2018-09-15,4,1,1,1,3,0,3,0,3
4979,2018-09-15,Huddersfield,Crystal Palace,0,1,A,2018-09-15,0,1,1,1,-1,0,0,3,-3
4980,2018-09-15,Man City,Fulham,3,0,H,2018-09-15,3,0,0,0,3,0,3,0,3
4981,2018-09-15,Newcastle,Arsenal,1,2,A,2018-09-15,1,2,2,2,-1,0,0,3,-3
4982,2018-09-15,Tottenham,Liverpool,1,2,A,2018-09-15,1,2,2,2,-1,0,0,3,-3
4983,2018-09-15,Watford,Man United,1,2,A,2018-09-15,1,2,2,2,-1,0,0,3,-3
4984,2018-09-16,Everton,West Ham,1,3,A,2018-09-22,1,3,3,3,-2,0,0,3,-3
4985,2018-09-16,Wolves,Burnley,1,0,H,2018-09-22,2,4,1,1,1,3,3,0,3
4986,2018-09-17,Southampton,Brighton,2,2,D,2018-09-22,2,3,5,5,-3,-2,1,1,0
4987,2018-09-22,Brighton,Tottenham,1,2,A,2018-09-22,3,2,4,4,-1,-2,0,3,-3
4988,2018-09-22,Burnley,Bournemouth,4,0,H,2018-09-22,4,0,1,1,3,-1,3,0,3
4989,2018-09-22,Cardiff,Man City,0,5,A,2018-09-22,0,5,5,5,-5,0,0,3,-3
4990,2018-09-22,Crystal Palace,Newcastle,0,0,D,2018-09-22,0,0,0,0,0,0,1,1,0
4991,2018-09-22,Fulham,Watford,1,1,D,2018-09-22,1,1,1,1,0,0,1,1,0
4992,2018-09-22,Leicester,Huddersfield,3,1,H,2018-09-22,3,1,1,1,2,0,3,0,3
4993,2018-09-22,Liverpool,Southampton,3,0,H,2018-09-22,3,2,0,0,3,2,3,0,3
4994,2018-09-22,Man United,Wolves,1,1,D,2018-09-22,1,2,1,1,0,1,1,1,0
4995,2018-09-23,Arsenal,Everton,2,0,H,2018-09-29,4,3,0,0,4,3,6,0,6
4996,2018-09-23,West Ham,Chelsea,0,0,D,2018-09-29,3,1,1,1,2,0,4,1,3
4997,2018-09-29,Arsenal,Watford,2,0,H,2018-09-29,4,0,0,0,4,0,6,0,6
4998,2018-09-29,Chelsea,Liverpool,1,1,D,2018-09-29,1,1,1,1,0,0,1,1,0
4999,2018-09-29,Everton,Fulham,3,0,H,2018-09-29,3,0,2,2,1,-2,3,0,3
5000,2018-09-29,Huddersfield,Tottenham,0,2,A,2018-09-29,0,2,2,2,-2,0,0,3,-3
5001,2018-09-29,Man City,Brighton,2,0,H,2018-09-29,2,0,0,0,2,0,3,0,3
5002,2018-09-29,Newcastle,Leicester,0,2,A,2018-09-29,0,2,2,2,-2,0,0,3,-3
5003,2018-09-29,West Ham,Man United,3,1,H,2018-09-29,3,1,1,1,2,0,4,0,4
5004,2018-09-29,Wolves,Southampton,2,0,H,2018-09-29,2,0,0,0,2,0,3,0,3
5005,2018-09-30,Cardiff,Burnley,1,2,A,2018-10-06,1,3,3,3,-2,0,0,3,-3
5006,2018-10-01,Bournemouth,Crystal Palace,2,1,H,2018-10-06,6,1,1,1,5,0,3,0,3
5007,2018-10-05,Brighton,West Ham,1,0,H,2018-10-06,1,0,0,0,1,0,3,0,3
5008,2018-10-06,Burnley,Huddersfield,1,1,D,2018-10-06,3,1,2,2,1,-1,1,1,0
5009,2018-10-06,Crystal Palace,Wolves,0,1,A,2018-10-06,1,1,3,3,-2,-2,0,3,-3
5010,2018-10-06,Leicester,Everton,1,2,A,2018-10-06,1,2,2,2,-1,0,0,3,-3
5011,2018-10-06,Man United,Newcastle,3,2,H,2018-10-06,3,2,2,2,1,0,3,0,3
5012,2018-10-06,Tottenham,Cardiff,1,0,H,2018-10-06,1,1,0,0,1,1,3,0,3
5013,2018-10-06,Watford,Bournemouth,0,4,A,2018-10-06,0,6,4,4,-4,2,0,3,-3
5014,2018-10-07,Fulham,Arsenal,1,5,A,2018-10-13,1,5,5,5,-4,0,0,3,-3
5015,2018-10-07,Liverpool,Man City,0,0,D,2018-10-13,0,0,0,0,0,0,1,1,0
5016,2018-10-07,Southampton,Chelsea,0,3,A,2018-10-13,0,3,3,3,-3,0,0,3,-3
5017,2018-10-20,Bournemouth,Southampton,0,0,D,2018-10-20,0,0,0,0,0,0,1,1,0
5018,2018-10-20,Cardiff,Fulham,4,2,H,2018-10-20,4,2,2,2,2,0,3,0,3
5019,2018-10-20,Chelsea,Man United,2,2,D,2018-10-20,2,2,2,2,0,0,1,1,0
5020,2018-10-20,Huddersfield,Liverpool,0,1,A,2018-10-20,0,1,1,1,-1,0,0,3,-3
5021,2018-10-20,Man City,Burnley,5,0,H,2018-10-20,5,0,0,0,5,0,3,0,3
5022,2018-10-20,Newcastle,Brighton,0,1,A,2018-10-20,0,1,1,1,-1,0,0,3,-3
5023,2018-10-20,West Ham,Tottenham,0,1,A,2018-10-20,0,1,1,1,-1,0,0,3,-3
5024,2018-10-20,Wolves,Watford,0,2,A,2018-10-20,0,2,2,2,-2,0,0,3,-3
5025,2018-10-21,Everton,Crystal Palace,2,0,H,2018-10-27,2,0,0,0,2,0,3,0,3
5026,2018-10-22,Arsenal,Leicester,3,1,H,2018-10-27,3,2,1,1,2,1,3,0,3
5027,2018-10-27,Brighton,Wolves,1,0,H,2018-10-27,1,0,0,0,1,0,3,0,3
5028,2018-10-27,Fulham,Bournemouth,0,3,A,2018-10-27,0,3,3,3,-3,0,0,3,-3
5029,2018-10-27,Leicester,West Ham,1,1,D,2018-10-27,2,1,4,4,-2,-3,1,1,0
5030,2018-10-27,Liverpool,Cardiff,4,1,H,2018-10-27,4,1,1,1,3,0,3,0,3
5031,2018-10-27,Southampton,Newcastle,0,0,D,2018-10-27,0,0,0,0,0,0,1,1,0
5032,2018-10-27,Watford,Huddersfield,3,0,H,2018-10-27,3,0,0,0,3,0,3,0,3
5033,2018-10-28,Burnley,Chelsea,0,4,A,2018-11-03,2,4,8,8,-6,-4,0,3,-3
5034,2018-10-28,Crystal Palace,Arsenal,2,2,D,2018-11-03,2,3,2,2,0,1,1,1,0
5035,2018-10-28,Man United,Everton,2,1,H,2018-11-03,4,4,2,2,2,2,3,0,3
5036,2018-10-29,Tottenham,Man City,0,1,A,2018-11-03,3,1,3,3,0,-2,0,3,-3
5037,2018-11-03,Arsenal,Liverpool,1,1,D,2018-11-03,3,1,3,3,0,-2,1,1,0
5038,2018-11-03,Bournemouth,Man United,1,2,A,2018-11-03,1,4,2,2,-1,2,0,3,-3
5039,2018-11-03,Cardiff,Leicester,0,1,A,2018-11-03,0,1,1,1,-1,0,0,3,-3
5040,2018-11-03,Everton,Brighton,3,1,H,2018-11-03,4,1,3,3,1,-2,3,0,3
5041,2018-11-03,Newcastle,Watford,1,0,H,2018-11-03,1,0,0,0,1,0,3,0,3
5042,2018-11-03,West Ham,Burnley,4,2,H,2018-11-03,4,2,2,2,2,0,3,0,3
5043,2018-11-03,Wolves,Tottenham,2,3,A,2018-11-03,2,3,3,3,-1,0,0,3,-3
5044,2018-11-04,Chelsea,Crystal Palace,3,1,H,2018-11-10,3,1,1,1,2,0,3,0,3
5045,2018-11-04,Man City,Southampton,6,1,H,2018-11-10,6,2,1,1,5,1,3,0,3
5046,2018-11-05,Huddersfield,Fulham,1,0,H,2018-11-10,2,0,1,1,1,-1,4,0,4
5047,2018-11-10,Cardiff,Brighton,2,1,H,2018-11-10,2,1,1,1,1,0,3,0,3
5048,2018-11-10,Crystal Palace,Tottenham,0,1,A,2018-11-10,1,1,4,4,-3,-3,0,3,-3
5049,2018-11-10,Huddersfield,West Ham,1,1,D,2018-11-10,2,1,1,1,1,0,4,1,3
5050,2018-11-10,Leicester,Burnley,0,0,D,2018-11-10,0,0,0,0,0,0,1,1,0
5051,2018-11-10,Newcastle,Bournemouth,2,1,H,2018-11-10,2,1,1,1,1,0,3,0,3
5052,2018-11-10,Southampton,Watford,1,1,D,2018-11-10,2,1,7,7,-5,-6,1,1,0
5053,2018-11-11,Arsenal,Wolves,1,1,D,2018-11-17,1,1,1,1,0,0,1,1,0
5054,2018-11-11,Chelsea,Everton,0,0,D,2018-11-17,0,0,0,0,0,0,1,1,0
5055,2018-11-11,Liverpool,Fulham,2,0,H,2018-11-17,2,0,0,0,2,0,3,0,3
5056,2018-11-11,Man City,Man United,3,1,H,2018-11-17,3,1,1,1,2,0,3,0,3
5057,2018-11-24,Brighton,Leicester,1,1,D,2018-11-24,1,1,1,1,0,0,1,1,0
5058,2018-11-24,Everton,Cardiff,1,0,H,2018-11-24,1,0,0,0,1,0,3,0,3
5059,2018-11-24,Fulham,Southampton,3,2,H,2018-11-24,3,2,2,2,1,0,3,0,3
5060,2018-11-24,Man United,Crystal Palace,0,0,D,2018-11-24,0,0,0,0,0,0,1,1,0
5061,2018-11-24,Tottenham,Chelsea,3,1,H,2018-11-24,3,1,1,1,2,0,3,0,3
5062,2018-11-24,Watford,Liverpool,0,3,A,2018-11-24,0,3,3,3,-3,0,0,3,-3
5063,2018-11-24,West Ham,Man City,0,4,A,2018-11-24,0,4,4,4,-4,0,0,3,-3
5064,2018-11-25,Bournemouth,Arsenal,1,2,A,2018-12-01,2,2,5,5,-3,-3,0,3,-3
5065,2018-11-25,Wolves,Huddersfield,0,2,A,2018-12-01,1,3,4,4,-3,-1,0,3,-3
5066,2018-11-26,Burnley,Newcastle,1,2,A,2018-12-01,1,2,4,4,-3,-2,0,3,-3
5067,2018-11-30,Cardiff,Wolves,2,1,H,2018-12-01,2,1,1,1,1,0,3,0,3
5068,2018-12-01,Crystal Palace,Burnley,2,0,H,2018-12-01,2,1,0,0,2,1,3,0,3
5069,2018-12-01,Huddersfield,Brighton,1,2,A,2018-12-01,3,2,2,2,1,0,0,3,-3
5070,2018-12-01,Leicester,Watford,2,0,H,2018-12-01,2,0,0,0,2,0,3,0,3
5071,2018-12-01,Man City,Bournemouth,3,1,H,2018-12-01,3,2,1,1,2,1,3,0,3
5072,2018-12-01,Newcastle,West Ham,0,3,A,2018-12-01,2,3,4,4,-2,-1,0,3,-3
5073,2018-12-01,Southampton,Man United,2,2,D,2018-12-01,2,2,2,2,0,0,1,1,0
5074,2018-12-02,Arsenal,Tottenham,4,2,H,2018-12-08,7,7,4,4,3,3,6,3,3
5075,2018-12-02,Chelsea,Fulham,2,0,H,2018-12-08,5,2,2,2,3,0,6,0,6
5076,2018-12-02,Liverpool,Everton,1,0,H,2018-12-08,8,1,1,1,7,0,3,0,3
5077,2018-12-04,Bournemouth,Huddersfield,2,1,H,2018-12-08,2,1,5,5,-3,-4,3,0,3
5078,2018-12-04,Brighton,Crystal Palace,3,1,H,2018-12-08,3,3,2,2,1,1,3,0,3
5079,2018-12-04,Watford,Man City,1,2,A,2018-12-08,1,2,2,2,-1,0,0,3,-3
5080,2018-12-04,West Ham,Cardiff,3,1,H,2018-12-08,6,2,3,3,3,-1,6,0,6
5081,2018-12-05,Burnley,Liverpool,1,3,A,2018-12-08,2,8,3,3,-1,5,3,6,-3
5082,2018-12-05,Everton,Newcastle,1,1,D,2018-12-08,1,1,2,2,-1,-1,1,1,0
5083,2018-12-05,Fulham,Leicester,1,1,D,2018-12-08,2,1,7,7,-5,-6,1,1,0
5084,2018-12-05,Man United,Arsenal,2,2,D,2018-12-08,6,7,3,3,3,4,4,1,3
5085,2018-12-05,Tottenham,Southampton,3,1,H,2018-12-08,7,1,5,5,2,-4,3,0,3
5086,2018-12-05,Wolves,Chelsea,2,1,H,2018-12-08,2,5,1,1,1,4,3,0,3
5087,2018-12-08,Arsenal,Huddersfield,1,0,H,2018-12-08,7,1,4,4,3,-3,6,0,6
5088,2018-12-08,Bournemouth,Liverpool,0,4,A,2018-12-08,2,8,5,5,-3,3,3,6,-3
5089,2018-12-08,Burnley,Brighton,1,0,H,2018-12-08,2,3,3,3,-1,0,3,0,3
5090,2018-12-08,Cardiff,Southampton,1,0,H,2018-12-08,2,1,3,3,-1,-2,3,0,3
5091,2018-12-08,Chelsea,Man City,2,0,H,2018-12-08,5,2,2,2,3,0,6,3,3
5092,2018-12-08,Leicester,Tottenham,0,2,A,2018-12-08,1,7,3,3,-2,4,0,3,-3
5093,2018-12-08,Man United,Fulham,4,1,H,2018-12-08,6,2,3,3,3,-1,4,0,4
5094,2018-12-08,West Ham,Crystal Palace,3,2,H,2018-12-08,6,3,3,3,3,0,6,0,6
5095,2018-12-09,Newcastle,Wolves,1,2,A,2018-12-15,2,4,2,2,0,2,0,3,-3
5096,2018-12-10,Everton,Watford,2,2,D,2018-12-15,3,5,5,5,-2,0,1,1,0
5097,2018-12-15,Crystal Palace,Leicester,1,0,H,2018-12-15,1,0,0,0,1,0,3,0,3
5098,2018-12-15,Fulham,West Ham,0,2,A,2018-12-15,0,2,2,2,-2,0,0,3,-3
5099,2018-12-15,Huddersfield,Newcastle,0,1,A,2018-12-15,0,2,1,1,-1,1,0,3,-3
5100,2018-12-15,Man City,Everton,3,1,H,2018-12-15,3,3,1,1,2,2,3,0,3
5101,2018-12-15,Tottenham,Burnley,1,0,H,2018-12-15,1,0,0,0,1,0,3,0,3
5102,2018-12-15,Watford,Cardiff,3,2,H,2018-12-15,5,2,4,4,1,-2,3,0,3
5103,2018-12-15,Wolves,Bournemouth,2,0,H,2018-12-15,4,0,1,1,3,-1,3,0,3
5104,2018-12-16,Brighton,Chelsea,1,2,A,2018-12-22,1,2,4,4,-3,-2,0,3,-3
5105,2018-12-16,Liverpool,Man United,3,1,H,2018-12-22,5,6,1,1,4,5,3,3,0
5106,2018-12-16,Southampton,Arsenal,3,2,H,2018-12-22,6,5,3,3,3,2,3,0,3
5107,2018-12-21,Wolves,Liverpool,0,2,A,2018-12-22,0,5,2,2,-2,3,0,3,-3
5108,2018-12-22,Arsenal,Burnley,3,1,H,2018-12-22,5,1,4,4,1,-3,3,0,3
5109,2018-12-22,Bournemouth,Brighton,2,0,H,2018-12-22,2,1,0,0,2,1,3,0,3
5110,2018-12-22,Cardiff,Man United,1,5,A,2018-12-22,1,6,5,5,-4,1,0,3,-3
5111,2018-12-22,Chelsea,Leicester,0,1,A,2018-12-22,2,1,2,2,0,-1,0,3,-3
5112,2018-12-22,Huddersfield,Southampton,1,3,A,2018-12-22,1,6,3,3,-2,3,0,3,-3
5113,2018-12-22,Man City,Crystal Palace,2,3,A,2018-12-22,2,3,3,3,-1,0,0,3,-3
5114,2018-12-22,Newcastle,Fulham,0,0,D,2018-12-22,0,0,0,0,0,0,1,1,0
5115,2018-12-22,West Ham,Watford,0,2,A,2018-12-22,0,2,2,2,-2,0,0,3,-3
5116,2018-12-23,Everton,Tottenham,2,6,A,2018-12-29,7,12,8,8,-1,4,0,3,-3
5117,2018-12-26,Brighton,Arsenal,1,1,D,2018-12-29,2,2,1,1,1,1,4,1,3
5118,2018-12-26,Burnley,Everton,1,5,A,2018-12-29,1,7,5,5,-4,2,0,3,-3
5119,2018-12-26,Crystal Palace,Cardiff,0,0,D,2018-12-29,0,1,0,0,0,1,1,4,-3
5120,2018-12-26,Fulham,Wolves,1,1,D,2018-12-29,2,4,1,1,1,3,4,4,0
5121,2018-12-26,Leicester,Man City,2,1,H,2018-12-29,2,1,2,2,0,-1,3,0,3
5122,2018-12-26,Liverpool,Newcastle,4,0,H,2018-12-29,9,1,1,1,8,0,6,1,5
5123,2018-12-26,Man United,Huddersfield,3,1,H,2018-12-29,3,1,1,1,2,0,3,0,3
5124,2018-12-26,Tottenham,Bournemouth,5,0,H,2018-12-29,12,0,5,5,7,-5,3,0,3
5125,2018-12-26,Watford,Chelsea,1,2,A,2018-12-29,2,2,3,3,-1,-1,1,3,-2
5126,2018-12-27,Southampton,West Ham,1,2,A,2018-12-29,1,2,2,2,-1,0,0,3,-3
5127,2018-12-29,Brighton,Everton,1,0,H,2018-12-29,2,7,1,1,1,6,4,3,1
5128,2018-12-29,Fulham,Huddersfield,1,0,H,2018-12-29,2,1,1,1,1,0,4,0,4
5129,2018-12-29,Leicester,Cardiff,0,1,A,2018-12-29,2,1,2,2,0,-1,3,4,-1
5130,2018-12-29,Liverpool,Arsenal,5,1,H,2018-12-29,9,2,1,1,8,1,6,1,5
5131,2018-12-29,Tottenham,Wolves,1,3,A,2018-12-29,12,4,5,5,7,-1,3,4,-1
5132,2018-12-29,Watford,Newcastle,1,1,D,2018-12-29,2,1,3,3,-1,-2,1,1,0
5133,2018-12-30,Burnley,West Ham,2,0,H,2019-01-05,4,2,1,1,3,1,3,0,3
5134,2018-12-30,Crystal Palace,Chelsea,0,1,A,2019-01-05,2,1,1,1,1,0,0,3,-3
5135,2018-12-30,Man United,Bournemouth,4,1,H,2019-01-05,6,4,1,1,5,3,3,0,3
5136,2018-12-30,Southampton,Man City,1,3,A,2019-01-05,1,5,3,3,-2,2,0,3,-3
5137,2019-01-01,Arsenal,Fulham,4,1,H,2019-01-05,4,1,1,1,3,0,3,0,3
5138,2019-01-01,Cardiff,Tottenham,0,3,A,2019-01-05,0,3,3,3,-3,0,0,3,-3
5139,2019-01-01,Everton,Leicester,0,1,A,2019-01-05,0,1,1,1,-1,0,0,3,-3
5140,2019-01-02,Bournemouth,Watford,3,3,D,2019-01-05,4,3,7,7,-3,-4,1,1,0
5141,2019-01-02,Chelsea,Southampton,0,0,D,2019-01-05,1,1,0,0,1,1,1,1,0
5142,2019-01-02,Huddersfield,Burnley,1,2,A,2019-01-05,1,4,2,2,-1,2,0,3,-3
5143,2019-01-02,Newcastle,Man United,0,2,A,2019-01-05,0,6,2,2,-2,4,0,3,-3
5144,2019-01-02,West Ham,Brighton,2,2,D,2019-01-05,2,2,4,4,-2,-2,1,1,0
5145,2019-01-02,Wolves,Crystal Palace,0,2,A,2019-01-05,0,2,2,2,-2,0,0,3,-3
5146,2019-01-03,Man City,Liverpool,2,1,H,2019-01-05,5,1,2,2,3,-1,3,0,3
5147,2019-01-12,Brighton,Liverpool,0,1,A,2019-01-12,0,1,1,1,-1,0,0,3,-3
5148,2019-01-12,Burnley,Fulham,2,1,H,2019-01-12,2,1,1,1,1,0,3,0,3
5149,2019-01-12,Cardiff,Huddersfield,0,0,D,2019-01-12,0,0,0,0,0,0,1,1,0
5150,2019-01-12,Chelsea,Newcastle,2,1,H,2019-01-12,2,1,1,1,1,0,3,0,3
5151,2019-01-12,Crystal Palace,Watford,1,2,A,2019-01-12,1,2,2,2,-1,0,0,3,-3
5152,2019-01-12,Leicester,Southampton,1,2,A,2019-01-12,1,2,2,2,-1,0,0,3,-3
5153,2019-01-12,West Ham,Arsenal,1,0,H,2019-01-12,1,0,0,0,1,0,3,0,3
5154,2019-01-13,Everton,Bournemouth,2,0,H,2019-01-19,3,2,2,2,1,0,3,0,3
5155,2019-01-13,Tottenham,Man United,0,1,A,2019-01-19,0,3,1,1,-1,2,0,3,-3
5156,2019-01-14,Man City,Wolves,3,0,H,2019-01-19,3,4,0,0,3,4,3,0,3
5157,2019-01-19,Arsenal,Chelsea,2,0,H,2019-01-19,2,0,0,0,2,0,3,0,3
5158,2019-01-19,Bournemouth,West Ham,2,0,H,2019-01-19,2,0,2,2,0,-2,3,0,3
5159,2019-01-19,Liverpool,Crystal Palace,4,3,H,2019-01-19,4,3,3,3,1,0,3,0,3
5160,2019-01-19,Man United,Brighton,2,1,H,2019-01-19,3,1,1,1,2,0,3,0,3
5161,2019-01-19,Newcastle,Cardiff,3,0,H,2019-01-19,3,0,0,0,3,0,3,0,3
5162,2019-01-19,Southampton,Everton,2,1,H,2019-01-19,2,3,1,1,1,2,3,0,3
5163,2019-01-19,Watford,Burnley,0,0,D,2019-01-19,0,0,0,0,0,0,1,1,0
5164,2019-01-19,Wolves,Leicester,4,3,H,2019-01-19,4,3,6,6,-2,-3,3,0,3
5165,2019-01-20,Fulham,Tottenham,1,2,A,2019-01-26,1,2,2,2,-1,0,0,3,-3
5166,2019-01-20,Huddersfield,Man City,0,3,A,2019-01-26,0,3,3,3,-3,0,0,3,-3
5167,2019-01-29,Arsenal,Cardiff,2,1,H,2019-02-02,2,3,1,1,1,2,3,0,3
5168,2019-01-29,Fulham,Brighton,4,2,H,2019-02-02,4,2,4,4,0,-2,3,0,3
5169,2019-01-29,Huddersfield,Everton,0,1,A,2019-02-02,0,2,6,6,-6,-4,0,3,-3
5170,2019-01-29,Man United,Burnley,2,2,D,2019-02-02,2,3,2,2,0,1,1,1,0
5171,2019-01-29,Newcastle,Man City,2,1,H,2019-02-02,2,1,2,2,0,-1,3,0,3
5172,2019-01-29,Wolves,West Ham,3,0,H,2019-02-02,6,0,1,1,5,-1,3,0,3
5173,2019-01-30,Bournemouth,Chelsea,4,0,H,2019-02-02,4,5,2,2,2,3,3,0,3
5174,2019-01-30,Liverpool,Leicester,1,1,D,2019-02-02,1,1,1,1,0,0,1,1,0
5175,2019-01-30,Southampton,Crystal Palace,1,1,D,2019-02-02,2,3,2,2,0,1,1,1,0
5176,2019-01-30,Tottenham,Watford,2,1,H,2019-02-02,3,1,1,1,2,0,6,1,5
5177,2019-02-02,Brighton,Watford,0,0,D,2019-02-02,2,1,4,4,-2,-3,1,1,0
5178,2019-02-02,Burnley,Southampton,1,1,D,2019-02-02,3,2,3,3,0,-1,1,1,0
5179,2019-02-02,Cardiff,Bournemouth,2,0,H,2019-02-02,3,4,2,2,1,2,3,0,3
5180,2019-02-02,Chelsea,Huddersfield,5,0,H,2019-02-02,5,0,4,4,1,-4,3,0,3
5181,2019-02-02,Crystal Palace,Fulham,2,0,H,2019-02-02,3,4,1,1,2,3,3,0,3
5182,2019-02-02,Everton,Wolves,1,3,A,2019-02-02,2,6,3,3,-1,3,0,3,-3
5183,2019-02-02,Tottenham,Newcastle,1,0,H,2019-02-02,3,2,1,1,2,1,6,0,6
5184,2019-02-03,Leicester,Man United,0,1,A,2019-02-09,0,4,1,1,-1,3,0,6,-6
5185,2019-02-03,Man City,Arsenal,3,1,H,2019-02-09,5,3,1,1,4,2,3,3,0
5186,2019-02-04,West Ham,Liverpool,1,1,D,2019-02-09,2,4,2,2,0,2,1,1,0
5187,2019-02-06,Everton,Man City,0,2,A,2019-02-09,0,5,3,3,-3,2,0,3,-3
5188,2019-02-09,Brighton,Burnley,1,3,A,2019-02-09,1,3,3,3,-2,0,0,3,-3
5189,2019-02-09,Crystal Palace,West Ham,1,1,D,2019-02-09,1,2,1,1,0,1,1,1,0
5190,2019-02-09,Fulham,Man United,0,3,A,2019-02-09,0,4,3,3,-3,1,0,6,-6
5191,2019-02-09,Huddersfield,Arsenal,1,2,A,2019-02-09,1,3,2,2,-1,1,0,3,-3
5192,2019-02-09,Liverpool,Bournemouth,3,0,H,2019-02-09,4,0,1,1,3,-1,3,0,3
5193,2019-02-09,Southampton,Cardiff,1,2,A,2019-02-09,1,2,2,2,-1,0,0,3,-3
5194,2019-02-09,Watford,Everton,1,0,H,2019-02-09,1,0,0,0,1,0,3,0,3
5195,2019-02-10,Man City,Chelsea,6,0,H,2019-02-16,6,0,0,0,6,0,3,0,3
5196,2019-02-10,Tottenham,Leicester,3,1,H,2019-02-16,3,1,1,1,2,0,3,0,3
5197,2019-02-11,Wolves,Newcastle,1,1,D,2019-02-16,1,1,1,1,0,0,1,1,0
5198,2019-02-22,Cardiff,Watford,1,5,A,2019-02-23,1,5,5,5,-4,0,0,3,-3
5199,2019-02-22,West Ham,Fulham,3,1,H,2019-02-23,3,1,1,1,2,0,3,0,3
5200,2019-02-23,Bournemouth,Wolves,1,1,D,2019-02-23,1,1,1,1,0,0,1,1,0
5201,2019-02-23,Burnley,Tottenham,2,1,H,2019-02-23,2,1,1,1,1,0,3,0,3
5202,2019-02-23,Leicester,Crystal Palace,1,4,A,2019-02-23,1,4,4,4,-3,0,0,3,-3
5203,2019-02-23,Newcastle,Huddersfield,2,0,H,2019-02-23,2,0,0,0,2,0,3,0,3
5204,2019-02-24,Arsenal,Southampton,2,0,H,2019-03-02,8,4,2,2,6,2,6,0,6
5205,2019-02-24,Man United,Liverpool,0,0,D,2019-03-02,6,5,3,3,3,2,4,1,3
5206,2019-02-26,Cardiff,Everton,0,3,A,2019-03-02,0,3,5,5,-5,-2,0,3,-3
5207,2019-02-26,Huddersfield,Wolves,1,0,H,2019-03-02,1,2,1,1,0,1,3,0,3
5208,2019-02-26,Leicester,Brighton,2,1,H,2019-03-02,2,2,1,1,1,1,3,0,3
5209,2019-02-26,Newcastle,Burnley,2,0,H,2019-03-02,2,1,2,2,0,-1,3,0,3
5210,2019-02-27,Arsenal,Bournemouth,5,1,H,2019-03-02,8,1,2,2,6,-1,6,0,6
5211,2019-02-27,Chelsea,Tottenham,2,0,H,2019-03-02,2,1,0,0,2,1,3,0,3
5212,2019-02-27,Crystal Palace,Man United,1,3,A,2019-03-02,4,6,4,4,0,2,0,3,-3
5213,2019-02-27,Liverpool,Watford,5,0,H,2019-03-02,5,0,0,0,5,0,3,0,3
5214,2019-02-27,Man City,West Ham,1,0,H,2019-03-02,2,2,0,0,2,2,3,0,3
5215,2019-02-27,Southampton,Fulham,2,0,H,2019-03-02,4,0,5,5,-1,-5,3,0,3
5216,2019-03-02,Bournemouth,Man City,0,1,A,2019-03-02,1,2,6,6,-5,-4,0,3,-3
5217,2019-03-02,Brighton,Huddersfield,1,0,H,2019-03-02,2,1,2,2,0,-1,3,0,3
5218,2019-03-02,Burnley,Crystal Palace,1,3,A,2019-03-02,1,4,5,5,-4,-1,0,3,-3
5219,2019-03-02,Man United,Southampton,3,2,H,2019-03-02,6,4,3,3,3,1,4,0,4
5220,2019-03-02,Tottenham,Arsenal,1,1,D,2019-03-02,1,8,3,3,-2,5,1,1,0
5221,2019-03-02,West Ham,Newcastle,2,0,H,2019-03-02,2,2,1,1,1,1,3,0,3
5222,2019-03-02,Wolves,Cardiff,2,0,H,2019-03-02,2,0,1,1,1,-1,3,0,3
5223,2019-03-03,Everton,Liverpool,0,0,D,2019-03-09,2,0,3,3,-1,-3,1,1,0
5224,2019-03-03,Fulham,Chelsea,1,2,A,2019-03-09,2,2,5,5,-3,-3,0,3,-3
5225,2019-03-03,Watford,Leicester,2,1,H,2019-03-09,3,4,4,4,-1,0,3,0,3
5226,2019-03-09,Cardiff,West Ham,2,0,H,2019-03-09,2,0,0,0,2,0,3,0,3
5227,2019-03-09,Crystal Palace,Brighton,1,2,A,2019-03-09,1,2,2,2,-1,0,0,3,-3
5228,2019-03-09,Huddersfield,Bournemouth,0,2,A,2019-03-09,0,2,2,2,-2,0,0,3,-3
5229,2019-03-09,Leicester,Fulham,3,1,H,2019-03-09,4,2,3,3,1,-1,3,0,3
5230,2019-03-09,Man City,Watford,3,1,H,2019-03-09,3,3,1,1,2,2,3,0,3
5231,2019-03-09,Newcastle,Everton,3,2,H,2019-03-09,3,2,2,2,1,0,3,0,3
5232,2019-03-09,Southampton,Tottenham,2,1,H,2019-03-09,2,1,1,1,1,0,3,0,3
5233,2019-03-10,Arsenal,Man United,2,0,H,2019-03-16,2,0,0,0,2,0,3,0,3
5234,2019-03-10,Chelsea,Wolves,1,1,D,2019-03-16,1,1,1,1,0,0,1,1,0
5235,2019-03-10,Liverpool,Burnley,4,2,H,2019-03-16,4,3,2,2,2,1,3,0,3
5236,2019-03-16,Bournemouth,Newcastle,2,2,D,2019-03-16,2,2,2,2,0,0,1,1,0
5237,2019-03-16,Burnley,Leicester,1,2,A,2019-03-16,3,2,6,6,-3,-4,0,3,-3
5238,2019-03-16,West Ham,Huddersfield,4,3,H,2019-03-16,4,3,3,3,1,0,3,0,3
5239,2019-03-17,Everton,Chelsea,2,0,H,2019-03-23,2,0,0,0,2,0,3,0,3
5240,2019-03-17,Fulham,Liverpool,1,2,A,2019-03-23,1,2,2,2,-1,0,0,3,-3
5241,2019-03-30,Brighton,Southampton,0,1,A,2019-03-30,0,1,1,1,-1,0,0,3,-3
5242,2019-03-30,Burnley,Wolves,2,0,H,2019-03-30,2,0,0,0,2,0,3,0,3
5243,2019-03-30,Crystal Palace,Huddersfield,2,0,H,2019-03-30,2,0,0,0,2,0,3,0,3
5244,2019-03-30,Fulham,Man City,0,2,A,2019-03-30,0,2,2,2,-2,0,0,3,-3
5245,2019-03-30,Leicester,Bournemouth,2,0,H,2019-03-30,2,0,0,0,2,0,3,0,3
5246,2019-03-30,Man United,Watford,2,1,H,2019-03-30,2,1,1,1,1,0,3,0,3
5247,2019-03-30,West Ham,Everton,0,2,A,2019-03-30,0,2,2,2,-2,0,0,3,-3
5248,2019-03-31,Cardiff,Chelsea,1,2,A,2019-04-06,1,5,4,4,-3,1,0,3,-3
5249,2019-03-31,Liverpool,Tottenham,2,1,H,2019-04-06,5,3,2,2,3,1,3,0,3
5250,2019-04-01,Arsenal,Newcastle,2,0,H,2019-04-06,2,0,0,0,2,0,3,0,3
5251,2019-04-02,Watford,Fulham,4,1,H,2019-04-06,4,1,1,1,3,0,3,0,3
5252,2019-04-02,Wolves,Man United,2,1,H,2019-04-06,2,1,1,1,1,0,3,0,3
5253,2019-04-03,Chelsea,Brighton,3,0,H,2019-04-06,5,0,1,1,4,-1,3,0,3
5254,2019-04-03,Man City,Cardiff,2,0,H,2019-04-06,2,1,0,0,2,1,3,0,3
5255,2019-04-03,Tottenham,Crystal Palace,2,0,H,2019-04-06,3,1,2,2,1,-1,3,3,0
5256,2019-04-05,Southampton,Liverpool,1,3,A,2019-04-06,1,5,3,3,-2,2,0,3,-3
5257,2019-04-06,Bournemouth,Burnley,1,3,A,2019-04-06,1,3,3,3,-2,0,0,3,-3
5258,2019-04-06,Huddersfield,Leicester,1,4,A,2019-04-06,1,4,4,4,-3,0,0,3,-3
5259,2019-04-06,Newcastle,Crystal Palace,0,1,A,2019-04-06,0,1,3,3,-3,-2,0,3,-3
5260,2019-04-07,Everton,Arsenal,1,0,H,2019-04-13,1,0,2,2,-1,-2,3,0,3
5261,2019-04-08,Chelsea,West Ham,2,0,H,2019-04-13,2,1,0,0,2,1,3,0,3
5262,2019-04-12,Leicester,Newcastle,0,1,A,2019-04-13,0,1,1,1,-1,0,0,3,-3
5263,2019-04-13,Brighton,Bournemouth,0,5,A,2019-04-13,0,5,5,5,-5,0,0,3,-3
5264,2019-04-13,Burnley,Cardiff,2,0,H,2019-04-13,2,0,0,0,2,0,3,0,3
5265,2019-04-13,Fulham,Everton,2,0,H,2019-04-13,2,1,0,0,2,1,3,0,3
5266,2019-04-13,Man United,West Ham,2,1,H,2019-04-13,2,1,1,1,1,0,3,0,3
5267,2019-04-13,Southampton,Wolves,3,1,H,2019-04-13,3,1,1,1,2,0,3,0,3
5268,2019-04-13,Tottenham,Huddersfield,4,0,H,2019-04-13,4,0,0,0,4,0,3,0,3
5269,2019-04-14,Crystal Palace,Man City,1,3,A,2019-04-20,1,4,3,3,-2,1,0,3,-3
5270,2019-04-14,Liverpool,Chelsea,2,0,H,2019-04-20,2,0,0,0,2,0,3,0,3
5271,2019-04-15,Watford,Arsenal,0,1,A,2019-04-20,2,1,2,2,0,-1,0,3,-3
5272,2019-04-16,Brighton,Cardiff,0,2,A,2019-04-20,0,2,2,2,-2,0,0,3,-3
5273,2019-04-20,Bournemouth,Fulham,0,1,A,2019-04-20,0,1,1,1,-1,0,0,3,-3
5274,2019-04-20,Huddersfield,Watford,1,2,A,2019-04-20,1,2,2,2,-1,0,0,3,-3
5275,2019-04-20,Man City,Tottenham,1,0,H,2019-04-20,4,0,1,1,3,-1,3,0,3
5276,2019-04-20,Newcastle,Southampton,3,1,H,2019-04-20,3,1,1,1,2,0,3,0,3
5277,2019-04-20,West Ham,Leicester,2,2,D,2019-04-20,2,2,2,2,0,0,1,1,0
5278,2019-04-20,Wolves,Brighton,0,0,D,2019-04-20,0,0,0,0,0,0,1,1,0
5279,2019-04-21,Arsenal,Crystal Palace,2,3,A,2019-04-27,3,3,6,6,-3,-3,0,3,-3
5280,2019-04-21,Cardiff,Liverpool,0,2,A,2019-04-27,0,7,3,3,-3,4,0,3,-3
5281,2019-04-21,Everton,Man United,4,0,H,2019-04-27,4,0,0,0,4,0,3,0,3
5282,2019-04-22,Chelsea,Burnley,2,2,D,2019-04-27,2,2,2,2,0,0,1,1,0
5283,2019-04-23,Tottenham,Brighton,1,0,H,2019-04-27,1,1,1,1,0,0,3,0,3
5284,2019-04-23,Watford,Southampton,1,1,D,2019-04-27,2,4,3,3,-1,1,1,1,0
5285,2019-04-24,Man United,Man City,0,2,A,2019-04-27,0,2,6,6,-6,-4,0,3,-3
5286,2019-04-24,Wolves,Arsenal,3,1,H,2019-04-27,5,3,2,2,3,1,3,0,3
5287,2019-04-26,Liverpool,Huddersfield,5,0,H,2019-04-27,7,0,0,0,7,0,3,0,3
5288,2019-04-27,Brighton,Newcastle,1,1,D,2019-04-27,1,1,2,2,-1,-1,1,1,0
5289,2019-04-27,Crystal Palace,Everton,0,0,D,2019-04-27,3,4,2,2,1,2,1,1,0
5290,2019-04-27,Fulham,Cardiff,1,0,H,2019-04-27,1,0,0,0,1,0,3,0,3
5291,2019-04-27,Southampton,Bournemouth,3,3,D,2019-04-27,4,3,4,4,0,-1,1,1,0
5292,2019-04-27,Tottenham,West Ham,0,1,A,2019-04-27,1,1,1,1,0,0,3,3,0
5293,2019-04-27,Watford,Wolves,1,2,A,2019-04-27,2,5,3,3,-1,2,1,3,-2
5294,2019-04-28,Burnley,Man City,0,1,A,2019-05-04,0,1,3,3,-3,-2,0,3,-3
5295,2019-04-28,Leicester,Arsenal,3,0,H,2019-05-04,3,0,0,0,3,0,3,0,3
5296,2019-04-28,Man United,Chelsea,1,1,D,2019-05-04,1,1,1,1,0,0,1,1,0
5297,2019-05-03,Everton,Burnley,2,0,H,2019-05-04,2,0,0,0,2,0,3,0,3
5298,2019-05-04,Bournemouth,Tottenham,1,0,H,2019-05-04,1,0,0,0,1,0,3,0,3
5299,2019-05-04,Cardiff,Crystal Palace,2,3,A,2019-05-04,2,3,3,3,-1,0,0,3,-3
5300,2019-05-04,Newcastle,Liverpool,2,3,A,2019-05-04,2,3,3,3,-1,0,0,3,-3
5301,2019-05-04,West Ham,Southampton,3,0,H,2019-05-04,3,0,0,0,3,0,3,0,3
5302,2019-05-04,Wolves,Fulham,1,0,H,2019-05-04,1,0,0,0,1,0,3,0,3
5303,2019-05-05,Arsenal,Brighton,1,1,D,2019-05-11,1,1,1,1,0,0,1,1,0
5304,2019-05-05,Chelsea,Watford,3,0,H,2019-05-11,3,0,0,0,3,0,3,0,3
5305,2019-05-05,Huddersfield,Man United,1,1,D,2019-05-11,1,1,1,1,0,0,1,1,0
5306,2019-05-06,Man City,Leicester,1,0,H,2019-05-11,1,0,0,0,1,0,3,0,3
5307,2019-05-12,Brighton,Man City,1,4,A,2019-05-18,1,4,4,4,-3,0,0,3,-3
5308,2019-05-12,Burnley,Arsenal,1,3,A,2019-05-18,1,3,3,3,-2,0,0,3,-3
5309,2019-05-12,Crystal Palace,Bournemouth,5,3,H,2019-05-18,5,3,3,3,2,0,3,0,3
5310,2019-05-12,Fulham,Newcastle,0,4,A,2019-05-18,0,4,4,4,-4,0,0,3,-3
5311,2019-05-12,Leicester,Chelsea,0,0,D,2019-05-18,0,0,0,0,0,0,1,1,0
5312,2019-05-12,Liverpool,Wolves,2,0,H,2019-05-18,2,0,0,0,2,0,3,0,3
5313,2019-05-12,Man United,Cardiff,0,2,A,2019-05-18,0,2,2,2,-2,0,0,3,-3
5314,2019-05-12,Southampton,Huddersfield,1,1,D,2019-05-18,1,1,1,1,0,0,1,1,0
5315,2019-05-12,Tottenham,Everton,2,2,D,2019-05-18,2,2,2,2,0,0,1,1,0
5316,2019-05-12,Watford,West Ham,1,4,A,2019-05-18,1,4,4,4,-3,0,0,3,-3
5317,2019-08-09,Liverpool,Norwich,4,1,H,2019-08-10,4,1,1,1,3,0,3,0,3
5318,2019-08-10,West Ham,Man City,0,5,A,2019-08-10,0,5,5,5,-5,0,0,3,-3
5319,2019-08-10,Bournemouth,Sheffield United,1,1,D,2019-08-10,1,1,1,1,0,0,1,1,0
5320,2019-08-10,Burnley,Southampton,3,0,H,2019-08-10,3,0,0,0,3,0,3,0,3
5321,2019-08-10,Crystal Palace,Everton,0,0,D,2019-08-10,0,0,0,0,0,0,1,1,0
5322,2019-08-10,Watford,Brighton,0,3,A,2019-08-10,0,3,3,3,-3,0,0,3,-3
5323,2019-08-10,Tottenham,Aston Villa,3,1,H,2019-08-10,3,1,1,1,2,0,3,0,3
5324,2019-08-11,Leicester,Wolves,0,0,D,2019-08-17,0,0,0,0,0,0,1,1,0
5325,2019-08-11,Newcastle,Arsenal,0,1,A,2019-08-17,1,3,4,4,-3,-1,0,3,-3
5326,2019-08-11,Man United,Chelsea,4,0,H,2019-08-17,4,0,0,0,4,0,3,0,3
5327,2019-08-17,Arsenal,Burnley,2,1,H,2019-08-17,3,1,1,1,2,0,3,0,3
5328,2019-08-17,Aston Villa,Bournemouth,1,2,A,2019-08-17,1,2,2,2,-1,0,0,3,-3
5329,2019-08-17,Brighton,West Ham,1,1,D,2019-08-17,1,1,1,1,0,0,1,1,0
5330,2019-08-17,Everton,Watford,1,0,H,2019-08-17,1,0,0,0,1,0,3,0,3
5331,2019-08-17,Norwich,Newcastle,3,1,H,2019-08-17,3,1,1,1,2,0,3,0,3
5332,2019-08-17,Southampton,Liverpool,1,2,A,2019-08-17,1,2,2,2,-1,0,0,3,-3
5333,2019-08-17,Man City,Tottenham,2,2,D,2019-08-17,2,2,2,2,0,0,1,1,0
5334,2019-08-18,Sheffield United,Crystal Palace,1,0,H,2019-08-24,2,2,2,2,0,0,3,3,0
5335,2019-08-18,Chelsea,Leicester,1,1,D,2019-08-24,4,3,3,3,1,0,1,4,-3
5336,2019-08-19,Wolves,Man United,1,1,D,2019-08-24,1,2,1,1,0,1,1,1,0
5337,2019-08-23,Aston Villa,Everton,2,0,H,2019-08-24,2,0,0,0,2,0,3,0,3
5338,2019-08-24,Norwich,Chelsea,2,3,A,2019-08-24,2,4,3,3,-1,1,0,3,-3
5339,2019-08-24,Brighton,Southampton,0,2,A,2019-08-24,0,2,2,2,-2,0,0,3,-3
5340,2019-08-24,Man United,Crystal Palace,1,2,A,2019-08-24,2,2,3,3,-1,-1,0,3,-3
5341,2019-08-24,Sheffield United,Leicester,1,2,A,2019-08-24,2,3,2,2,0,1,3,4,-1
5342,2019-08-24,Watford,West Ham,1,3,A,2019-08-24,1,3,3,3,-2,0,0,3,-3
5343,2019-08-24,Liverpool,Arsenal,3,1,H,2019-08-24,3,1,1,1,2,0,3,0,3
5344,2019-08-25,Bournemouth,Man City,1,3,A,2019-08-31,2,7,6,6,-4,1,0,3,-3
5345,2019-08-25,Tottenham,Newcastle,0,1,A,2019-08-31,0,2,1,1,-1,1,0,3,-3
5346,2019-08-25,Wolves,Burnley,1,1,D,2019-08-31,1,1,1,1,0,0,1,1,0
5347,2019-08-31,Southampton,Man United,1,1,D,2019-08-31,1,1,1,1,0,0,1,1,0
5348,2019-08-31,Chelsea,Sheffield United,2,2,D,2019-08-31,2,2,2,2,0,0,1,1,0
5349,2019-08-31,Crystal Palace,Aston Villa,1,0,H,2019-08-31,1,0,0,0,1,0,3,0,3
5350,2019-08-31,Leicester,Bournemouth,3,1,H,2019-08-31,3,2,1,1,2,1,3,0,3
5351,2019-08-31,Man City,Brighton,4,0,H,2019-08-31,7,0,1,1,6,-1,3,0,3
5352,2019-08-31,Newcastle,Watford,1,1,D,2019-08-31,2,1,1,1,1,0,1,1,0
5353,2019-08-31,West Ham,Norwich,2,0,H,2019-08-31,2,0,0,0,2,0,3,0,3
5354,2019-08-31,Burnley,Liverpool,0,3,A,2019-08-31,1,3,4,4,-3,-1,0,3,-3
5355,2019-09-01,Everton,Wolves,3,2,H,2019-09-07,3,2,2,2,1,0,3,0,3
5356,2019-09-01,Arsenal,Tottenham,2,2,D,2019-09-07,2,2,2,2,0,0,1,1,0
5357,2019-09-14,Liverpool,Newcastle,3,1,H,2019-09-14,3,1,1,1,2,0,3,0,3
5358,2019-09-14,Brighton,Burnley,1,1,D,2019-09-14,1,1,1,1,0,0,1,1,0
5359,2019-09-14,Man United,Leicester,1,0,H,2019-09-14,1,0,0,0,1,0,3,0,3
5360,2019-09-14,Sheffield United,Southampton,0,1,A,2019-09-14,0,1,1,1,-1,0,0,3,-3
5361,2019-09-14,Tottenham,Crystal Palace,4,0,H,2019-09-14,4,0,0,0,4,0,3,0,3
5362,2019-09-14,Wolves,Chelsea,2,5,A,2019-09-14,2,5,5,5,-3,0,0,3,-3
5363,2019-09-14,Norwich,Man City,3,2,H,2019-09-14,3,2,2,2,1,0,3,0,3
5364,2019-09-15,Bournemouth,Everton,3,1,H,2019-09-21,6,1,2,2,4,-1,3,0,3
5365,2019-09-15,Watford,Arsenal,2,2,D,2019-09-21,2,2,10,10,-8,-8,1,1,0
5366,2019-09-16,Aston Villa,West Ham,0,0,D,2019-09-21,0,0,0,0,0,0,1,1,0
5367,2019-09-20,Southampton,Bournemouth,1,3,A,2019-09-21,1,6,3,3,-2,3,0,3,-3
5368,2019-09-21,Leicester,Tottenham,2,1,H,2019-09-21,2,1,1,1,1,0,3,0,3
5369,2019-09-21,Burnley,Norwich,2,0,H,2019-09-21,2,0,0,0,2,0,3,0,3
5370,2019-09-21,Everton,Sheffield United,0,2,A,2019-09-21,1,2,5,5,-4,-3,0,3,-3
5371,2019-09-21,Man City,Watford,8,0,H,2019-09-21,8,2,0,0,8,2,3,0,3
5372,2019-09-21,Newcastle,Brighton,0,0,D,2019-09-21,0,0,0,0,0,0,1,1,0
5373,2019-09-22,Crystal Palace,Wolves,1,1,D,2019-09-28,3,3,1,1,2,2,4,1,3
5374,2019-09-22,West Ham,Man United,2,0,H,2019-09-28,4,0,2,2,2,-2,3,0,3
5375,2019-09-22,Arsenal,Aston Villa,3,2,H,2019-09-28,3,4,2,2,1,2,3,0,3
5376,2019-09-22,Chelsea,Liverpool,1,2,A,2019-09-28,3,3,2,2,1,1,3,6,-3
5377,2019-09-28,Sheffield United,Liverpool,0,1,A,2019-09-28,0,3,1,1,-1,2,0,6,-6
5378,2019-09-28,Aston Villa,Burnley,2,2,D,2019-09-28,4,2,5,5,-1,-3,1,1,0
5379,2019-09-28,Bournemouth,West Ham,2,2,D,2019-09-28,2,4,2,2,0,2,1,1,0
5380,2019-09-28,Chelsea,Brighton,2,0,H,2019-09-28,3,0,2,2,1,-2,3,0,3
5381,2019-09-28,Crystal Palace,Norwich,2,0,H,2019-09-28,3,0,1,1,2,-1,4,0,4
5382,2019-09-28,Tottenham,Southampton,2,1,H,2019-09-28,2,1,1,1,1,0,3,0,3
5383,2019-09-28,Wolves,Watford,2,0,H,2019-09-28,3,0,1,1,2,-1,3,0,3
5384,2019-09-28,Everton,Man City,1,3,A,2019-09-28,1,3,3,3,-2,0,0,3,-3
5385,2019-09-29,Leicester,Newcastle,5,0,H,2019-10-05,6,0,2,2,4,-2,3,0,3
5386,2019-09-30,Man United,Arsenal,1,1,D,2019-10-05,1,1,1,1,0,0,1,1,0
5387,2019-10-05,Brighton,Tottenham,3,0,H,2019-10-05,3,0,0,0,3,0,3,0,3
5388,2019-10-05,Burnley,Everton,1,0,H,2019-10-05,1,0,0,0,1,0,3,0,3
5389,2019-10-05,Liverpool,Leicester,2,1,H,2019-10-05,2,6,1,1,1,5,3,0,3
5390,2019-10-05,Norwich,Aston Villa,1,5,A,2019-10-05,1,5,5,5,-4,0,0,3,-3
5391,2019-10-05,Watford,Sheffield United,0,0,D,2019-10-05,0,0,0,0,0,0,1,1,0
5392,2019-10-05,West Ham,Crystal Palace,1,2,A,2019-10-05,1,2,2,2,-1,0,0,3,-3
5393,2019-10-06,Arsenal,Bournemouth,1,0,H,2019-10-12,1,0,0,0,1,0,3,0,3
5394,2019-10-06,Man City,Wolves,0,2,A,2019-10-12,0,2,2,2,-2,0,0,3,-3
5395,2019-10-06,Southampton,Chelsea,1,4,A,2019-10-12,1,4,4,4,-3,0,0,3,-3
5396,2019-10-06,Newcastle,Man United,1,0,H,2019-10-12,1,0,0,0,1,0,3,0,3
5397,2019-10-19,Everton,West Ham,2,0,H,2019-10-19,2,0,0,0,2,0,3,0,3
5398,2019-10-19,Aston Villa,Brighton,2,1,H,2019-10-19,2,1,1,1,1,0,3,0,3
5399,2019-10-19,Bournemouth,Norwich,0,0,D,2019-10-19,0,0,0,0,0,0,1,1,0
5400,2019-10-19,Chelsea,Newcastle,1,0,H,2019-10-19,1,0,0,0,1,0,3,0,3
5401,2019-10-19,Leicester,Burnley,2,1,H,2019-10-19,2,1,1,1,1,0,3,0,3
5402,2019-10-19,Tottenham,Watford,1,1,D,2019-10-19,1,1,1,1,0,0,1,1,0
5403,2019-10-19,Wolves,Southampton,1,1,D,2019-10-19,1,1,1,1,0,0,1,1,0
5404,2019-10-19,Crystal Palace,Man City,0,2,A,2019-10-19,0,2,2,2,-2,0,0,3,-3
5405,2019-10-20,Man United,Liverpool,1,1,D,2019-10-26,1,1,1,1,0,0,1,1,0
5406,2019-10-21,Sheffield United,Arsenal,1,0,H,2019-10-26,2,0,1,1,1,-1,3,0,3
5407,2019-10-25,Southampton,Leicester,0,9,A,2019-10-26,0,9,9,9,-9,0,0,3,-3
5408,2019-10-26,Man City,Aston Villa,3,0,H,2019-10-26,3,0,0,0,3,0,3,0,3
5409,2019-10-26,Brighton,Everton,3,2,H,2019-10-26,3,2,2,2,1,0,3,0,3
5410,2019-10-26,Watford,Bournemouth,0,0,D,2019-10-26,0,0,0,0,0,0,1,1,0
5411,2019-10-26,West Ham,Sheffield United,1,1,D,2019-10-26,1,2,1,1,0,1,1,1,0
5412,2019-10-26,Burnley,Chelsea,2,4,A,2019-10-26,2,4,4,4,-2,0,0,3,-3
5413,2019-10-27,Newcastle,Wolves,1,1,D,2019-11-02,4,2,3,3,1,-1,1,2,-1
5414,2019-10-27,Arsenal,Crystal Palace,2,2,D,2019-11-02,3,2,3,3,0,-1,2,1,1
5415,2019-10-27,Liverpool,Tottenham,2,1,H,2019-11-02,4,1,2,2,2,-1,3,0,3
5416,2019-10-27,Norwich,Man United,1,3,A,2019-11-02,1,3,5,5,-4,-2,0,3,-3
5417,2019-11-02,Bournemouth,Man United,1,0,H,2019-11-02,1,3,0,0,1,3,3,3,0
5418,2019-11-02,Arsenal,Wolves,1,1,D,2019-11-02,3,2,3,3,0,-1,2,2,0
5419,2019-11-02,Aston Villa,Liverpool,1,2,A,2019-11-02,1,4,2,2,-1,2,0,3,-3
5420,2019-11-02,Brighton,Norwich,2,0,H,2019-11-02,2,1,0,0,2,1,3,0,3
5421,2019-11-02,Man City,Southampton,2,1,H,2019-11-02,2,1,1,1,1,0,3,0,3
5422,2019-11-02,Sheffield United,Burnley,3,0,H,2019-11-02,3,0,0,0,3,0,3,0,3
5423,2019-11-02,West Ham,Newcastle,2,3,A,2019-11-02,2,4,3,3,-1,1,0,3,-3
5424,2019-11-02,Watford,Chelsea,1,2,A,2019-11-02,1,2,2,2,-1,0,0,3,-3
5425,2019-11-03,Crystal Palace,Leicester,0,2,A,2019-11-09,0,4,4,4,-4,0,0,3,-3
5426,2019-11-03,Everton,Tottenham,1,1,D,2019-11-09,3,2,2,2,1,0,1,1,0
5427,2019-11-08,Norwich,Watford,0,2,A,2019-11-09,0,2,2,2,-2,0,0,3,-3
5428,2019-11-09,Chelsea,Crystal Palace,2,0,H,2019-11-09,2,0,0,0,2,0,3,0,3
5429,2019-11-09,Burnley,West Ham,3,0,H,2019-11-09,3,0,0,0,3,0,3,0,3
5430,2019-11-09,Newcastle,Bournemouth,2,1,H,2019-11-09,2,1,1,1,1,0,3,0,3
5431,2019-11-09,Southampton,Everton,1,2,A,2019-11-09,1,3,2,2,-1,1,0,3,-3
5432,2019-11-09,Tottenham,Sheffield United,1,1,D,2019-11-09,2,1,2,2,0,-1,1,1,0
5433,2019-11-09,Leicester,Arsenal,2,0,H,2019-11-09,4,0,0,0,4,0,3,0,3
5434,2019-11-10,Man United,Brighton,3,1,H,2019-11-16,3,1,1,1,2,0,3,0,3
5435,2019-11-10,Wolves,Aston Villa,2,1,H,2019-11-16,2,1,1,1,1,0,3,0,3
5436,2019-11-10,Liverpool,Man City,3,1,H,2019-11-16,3,1,1,1,2,0,3,0,3
5437,2019-11-23,West Ham,Tottenham,2,3,A,2019-11-23,2,3,3,3,-1,0,0,3,-3
5438,2019-11-23,Arsenal,Southampton,2,2,D,2019-11-23,2,2,2,2,0,0,1,1,0
5439,2019-11-23,Bournemouth,Wolves,1,2,A,2019-11-23,1,2,2,2,-1,0,0,3,-3
5440,2019-11-23,Brighton,Leicester,0,2,A,2019-11-23,0,2,2,2,-2,0,0,3,-3
5441,2019-11-23,Crystal Palace,Liverpool,1,2,A,2019-11-23,1,2,2,2,-1,0,0,3,-3
5442,2019-11-23,Everton,Norwich,0,2,A,2019-11-23,0,2,2,2,-2,0,0,3,-3
5443,2019-11-23,Watford,Burnley,0,3,A,2019-11-23,0,3,3,3,-3,0,0,3,-3
5444,2019-11-23,Man City,Chelsea,2,1,H,2019-11-23,2,1,1,1,1,0,3,0,3
5445,2019-11-24,Sheffield United,Man United,3,3,D,2019-11-30,3,3,3,3,0,0,1,1,0
5446,2019-11-25,Aston Villa,Newcastle,2,0,H,2019-11-30,2,2,0,0,2,2,3,0,3
5447,2019-11-30,Newcastle,Man City,2,2,D,2019-11-30,2,2,4,4,-2,-2,1,1,0
5448,2019-11-30,Burnley,Crystal Palace,0,2,A,2019-11-30,0,2,2,2,-2,0,0,3,-3
5449,2019-11-30,Chelsea,West Ham,0,1,A,2019-11-30,0,1,1,1,-1,0,0,3,-3
5450,2019-11-30,Liverpool,Brighton,2,1,H,2019-11-30,2,1,1,1,1,0,3,0,3
5451,2019-11-30,Tottenham,Bournemouth,3,2,H,2019-11-30,3,2,2,2,1,0,3,0,3
5452,2019-11-30,Southampton,Watford,2,1,H,2019-11-30,2,1,1,1,1,0,3,0,3
5453,2019-12-01,Norwich,Arsenal,2,2,D,2019-12-07,3,3,4,4,-1,-1,1,1,0
5454,2019-12-01,Wolves,Sheffield United,1,1,D,2019-12-07,3,1,1,1,2,0,4,1,3
5455,2019-12-01,Leicester,Everton,2,1,H,2019-12-07,4,6,1,1,3,5,6,0,6
5456,2019-12-01,Man United,Aston Villa,2,2,D,2019-12-07,6,3,4,4,2,-1,4,1,3
5457,2019-12-03,Crystal Palace,Bournemouth,1,0,H,2019-12-07,1,0,0,0,1,0,3,0,3
5458,2019-12-03,Burnley,Man City,1,4,A,2019-12-07,1,5,9,9,-8,-4,0,3,-3
5459,2019-12-04,Chelsea,Aston Villa,2,1,H,2019-12-07,3,3,4,4,-1,-1,3,1,2
5460,2019-12-04,Leicester,Watford,2,0,H,2019-12-07,4,0,1,1,3,-1,6,0,6
5461,2019-12-04,Man United,Tottenham,2,1,H,2019-12-07,6,6,4,4,2,2,4,0,4
5462,2019-12-04,Southampton,Norwich,2,1,H,2019-12-07,2,3,1,1,1,2,3,0,3
5463,2019-12-04,Wolves,West Ham,2,0,H,2019-12-07,3,0,1,1,2,-1,4,0,4
5464,2019-12-04,Liverpool,Everton,5,2,H,2019-12-07,8,6,2,2,6,4,3,0,3
5465,2019-12-05,Sheffield United,Newcastle,0,2,A,2019-12-07,1,2,3,3,-2,-1,0,3,-3
5466,2019-12-05,Arsenal,Brighton,1,2,A,2019-12-07,3,2,4,4,-1,-2,0,3,-3
5467,2019-12-07,Everton,Chelsea,3,1,H,2019-12-07,6,3,8,8,-2,-5,3,0,3
5468,2019-12-07,Bournemouth,Liverpool,0,3,A,2019-12-07,0,8,4,4,-4,4,0,3,-3
5469,2019-12-07,Tottenham,Burnley,5,0,H,2019-12-07,6,1,2,2,4,-1,3,0,3
5470,2019-12-07,Watford,Crystal Palace,0,0,D,2019-12-07,0,1,2,2,-2,-1,1,1,0
5471,2019-12-07,Man City,Man United,1,2,A,2019-12-07,5,6,3,3,2,3,0,3,-3
5472,2019-12-08,Aston Villa,Leicester,1,4,A,2019-12-14,1,5,6,6,-5,-1,0,3,-3
5473,2019-12-08,Newcastle,Southampton,2,1,H,2019-12-14,2,1,2,2,0,-1,3,0,3
5474,2019-12-08,Norwich,Sheffield United,1,2,A,2019-12-14,2,4,3,3,-1,1,0,3,-3
5475,2019-12-08,Brighton,Wolves,2,2,D,2019-12-14,2,2,2,2,0,0,1,1,0
5476,2019-12-09,West Ham,Arsenal,1,3,A,2019-12-14,2,3,3,3,-1,0,0,3,-3
5477,2019-12-14,Liverpool,Watford,2,0,H,2019-12-14,2,0,0,0,2,0,3,0,3
5478,2019-12-14,Burnley,Newcastle,1,0,H,2019-12-14,1,2,0,0,1,2,3,0,3
5479,2019-12-14,Chelsea,Bournemouth,0,1,A,2019-12-14,0,1,1,1,-1,0,0,3,-3
5480,2019-12-14,Leicester,Norwich,1,1,D,2019-12-14,5,2,2,2,3,0,1,1,0
5481,2019-12-14,Sheffield United,Aston Villa,2,0,H,2019-12-14,4,1,1,1,3,0,3,0,3
5482,2019-12-14,Southampton,West Ham,0,1,A,2019-12-14,1,2,3,3,-2,-1,0,3,-3
5483,2019-12-15,Man United,Everton,1,1,D,2019-12-21,1,1,1,1,0,0,1,1,0
5484,2019-12-15,Wolves,Tottenham,1,2,A,2019-12-21,3,2,3,3,0,-1,0,3,-3
5485,2019-12-15,Arsenal,Man City,0,3,A,2019-12-21,0,6,3,3,-3,3,0,3,-3
5486,2019-12-16,Crystal Palace,Brighton,1,1,D,2019-12-21,1,1,2,2,-1,-1,1,1,0
5487,2019-12-21,Everton,Arsenal,0,0,D,2019-12-21,1,0,1,1,0,-1,1,1,0
5488,2019-12-21,Aston Villa,Southampton,1,3,A,2019-12-21,1,3,3,3,-2,0,0,3,-3
5489,2019-12-21,Bournemouth,Burnley,0,1,A,2019-12-21,0,1,1,1,-1,0,0,3,-3
5490,2019-12-21,Brighton,Sheffield United,0,1,A,2019-12-21,1,1,2,2,-1,-1,0,3,-3
5491,2019-12-21,Newcastle,Crystal Palace,1,0,H,2019-12-21,1,1,0,0,1,1,3,0,3
5492,2019-12-21,Norwich,Wolves,1,2,A,2019-12-21,1,3,2,2,-1,1,0,3,-3
5493,2019-12-21,Man City,Leicester,3,1,H,2019-12-21,6,1,1,1,5,0,3,0,3
5494,2019-12-22,Watford,Man United,2,0,H,2019-12-28,6,6,1,1,5,5,6,3,3
5495,2019-12-22,Tottenham,Chelsea,0,2,A,2019-12-28,4,2,5,5,-1,-3,3,3,0
5496,2019-12-26,Tottenham,Brighton,2,1,H,2019-12-28,4,3,5,5,-1,-2,3,0,3
5497,2019-12-26,Aston Villa,Norwich,1,0,H,2019-12-28,1,2,3,3,-2,-1,3,0,3
5498,2019-12-26,Bournemouth,Arsenal,1,1,D,2019-12-28,1,1,3,3,-2,-2,1,1,0
5499,2019-12-26,Chelsea,Southampton,0,2,A,2019-12-28,2,3,2,2,0,1,0,3,-3
5500,2019-12-26,Crystal Palace,West Ham,2,1,H,2019-12-28,3,2,2,2,1,0,3,0,3
5501,2019-12-26,Everton,Burnley,1,0,H,2019-12-28,3,0,1,1,2,-1,3,0,3
5502,2019-12-26,Sheffield United,Watford,1,1,D,2019-12-28,1,6,1,1,0,5,1,1,0
5503,2019-12-26,Man United,Newcastle,4,1,H,2019-12-28,6,2,3,3,3,-1,3,0,3
5504,2019-12-26,Leicester,Liverpool,0,4,A,2019-12-28,2,4,5,5,-3,-1,0,3,-3
5505,2019-12-27,Wolves,Man City,3,2,H,2019-12-28,3,2,2,2,1,0,3,0,3
5506,2019-12-28,Brighton,Bournemouth,2,0,H,2019-12-28,3,1,2,2,1,-1,3,0,3
5507,2019-12-28,Newcastle,Everton,1,2,A,2019-12-28,2,3,6,6,-4,-3,0,3,-3
5508,2019-12-28,Southampton,Crystal Palace,1,1,D,2019-12-28,3,3,1,1,2,2,1,1,0
5509,2019-12-28,Watford,Aston Villa,3,0,H,2019-12-28,6,1,1,1,5,0,6,0,6
5510,2019-12-28,Norwich,Tottenham,2,2,D,2019-12-28,2,4,3,3,-1,1,1,1,0
5511,2019-12-28,West Ham,Leicester,1,2,A,2019-12-28,2,2,4,4,-2,-2,0,3,-3
5512,2019-12-28,Burnley,Man United,0,2,A,2019-12-28,0,6,3,3,-3,3,0,3,-3
5513,2019-12-29,Arsenal,Chelsea,1,2,A,2020-01-04,3,3,2,2,1,1,3,4,-1
5514,2019-12-29,Liverpool,Wolves,1,0,H,2020-01-04,3,1,0,0,3,1,6,0,6
5515,2019-12-29,Man City,Sheffield United,2,0,H,2020-01-04,4,0,1,1,3,-1,6,0,6
5516,2020-01-01,Brighton,Chelsea,1,1,D,2020-01-04,1,3,1,1,0,2,1,4,-3
5517,2020-01-01,Burnley,Aston Villa,1,2,A,2020-01-04,1,2,2,2,-1,0,0,3,-3
5518,2020-01-01,Newcastle,Leicester,0,3,A,2020-01-04,0,3,3,3,-3,0,0,3,-3
5519,2020-01-01,Southampton,Tottenham,1,0,H,2020-01-04,1,0,0,0,1,0,3,0,3
5520,2020-01-01,Watford,Wolves,2,1,H,2020-01-04,2,1,1,1,1,0,3,0,3
5521,2020-01-01,Man City,Everton,2,1,H,2020-01-04,4,1,1,1,3,0,6,0,6
5522,2020-01-01,Norwich,Crystal Palace,1,1,D,2020-01-04,1,1,1,1,0,0,1,1,0
5523,2020-01-01,West Ham,Bournemouth,4,0,H,2020-01-04,4,0,0,0,4,0,3,0,3
5524,2020-01-01,Arsenal,Man United,2,0,H,2020-01-04,3,0,2,2,1,-2,3,0,3
5525,2020-01-02,Liverpool,Sheffield United,2,0,H,2020-01-04,3,0,0,0,3,0,6,0,6
5526,2020-01-10,Sheffield United,West Ham,1,0,H,2020-01-11,1,0,0,0,1,0,3,0,3
5527,2020-01-11,Crystal Palace,Arsenal,1,1,D,2020-01-11,1,1,1,1,0,0,1,1,0
5528,2020-01-11,Chelsea,Burnley,3,0,H,2020-01-11,3,0,0,0,3,0,3,0,3
5529,2020-01-11,Everton,Brighton,1,0,H,2020-01-11,1,0,0,0,1,0,3,0,3
5530,2020-01-11,Leicester,Southampton,1,2,A,2020-01-11,1,2,2,2,-1,0,0,3,-3
5531,2020-01-11,Man United,Norwich,4,0,H,2020-01-11,4,0,0,0,4,0,3,0,3
5532,2020-01-11,Wolves,Newcastle,1,1,D,2020-01-11,1,1,1,1,0,0,1,1,0
5533,2020-01-11,Tottenham,Liverpool,0,1,A,2020-01-11,0,1,1,1,-1,0,0,3,-3
5534,2020-01-12,Bournemouth,Watford,0,3,A,2020-01-18,0,3,4,4,-4,-1,0,3,-3
5535,2020-01-12,Aston Villa,Man City,1,6,A,2020-01-18,2,8,7,7,-5,1,0,3,-3
5536,2020-01-18,Watford,Tottenham,0,0,D,2020-01-18,3,0,0,0,3,0,1,1,0
5537,2020-01-18,Arsenal,Sheffield United,1,1,D,2020-01-18,1,1,1,1,0,0,1,1,0
5538,2020-01-18,Brighton,Aston Villa,1,1,D,2020-01-18,1,2,1,1,0,1,1,1,0
5539,2020-01-18,Man City,Crystal Palace,2,2,D,2020-01-18,8,2,3,3,5,-1,1,1,0
5540,2020-01-18,Norwich,Bournemouth,1,0,H,2020-01-18,1,0,0,0,1,0,3,0,3
5541,2020-01-18,Southampton,Wolves,2,3,A,2020-01-18,2,3,3,3,-1,0,0,3,-3
5542,2020-01-18,West Ham,Everton,1,1,D,2020-01-18,1,1,1,1,0,0,1,1,0
5543,2020-01-18,Newcastle,Chelsea,1,0,H,2020-01-18,1,0,0,0,1,0,3,0,3
5544,2020-01-19,Burnley,Leicester,2,1,H,2020-01-25,4,5,1,1,3,4,3,0,3
5545,2020-01-19,Liverpool,Man United,2,0,H,2020-01-25,4,0,1,1,3,-1,3,0,3
5546,2020-01-21,Aston Villa,Watford,2,1,H,2020-01-25,2,1,1,1,1,0,3,0,3
5547,2020-01-21,Bournemouth,Brighton,3,1,H,2020-01-25,3,1,1,1,2,0,3,0,3
5548,2020-01-21,Crystal Palace,Southampton,0,2,A,2020-01-25,0,2,2,2,-2,0,0,3,-3
5549,2020-01-21,Everton,Newcastle,2,2,D,2020-01-25,2,2,2,2,0,0,1,1,0
5550,2020-01-21,Sheffield United,Man City,0,1,A,2020-01-25,0,1,1,1,-1,0,0,3,-3
5551,2020-01-21,Chelsea,Arsenal,2,2,D,2020-01-25,2,2,2,2,0,0,1,1,0
5552,2020-01-22,Leicester,West Ham,4,1,H,2020-01-25,5,1,3,3,2,-2,3,0,3
5553,2020-01-22,Tottenham,Norwich,2,1,H,2020-01-25,2,1,1,1,1,0,3,0,3
5554,2020-01-22,Man United,Burnley,0,2,A,2020-01-25,0,4,4,4,-4,0,0,3,-3
5555,2020-01-23,Wolves,Liverpool,1,2,A,2020-01-25,1,4,2,2,-1,2,0,3,-3
5556,2020-01-29,West Ham,Liverpool,0,2,A,2020-02-01,3,6,5,5,-2,1,1,3,-2
5557,2020-02-01,Leicester,Chelsea,2,2,D,2020-02-01,2,2,2,2,0,0,1,1,0
5558,2020-02-01,Bournemouth,Aston Villa,2,1,H,2020-02-01,2,1,1,1,1,0,3,0,3
5559,2020-02-01,Crystal Palace,Sheffield United,0,1,A,2020-02-01,0,1,1,1,-1,0,0,3,-3
5560,2020-02-01,Liverpool,Southampton,4,0,H,2020-02-01,6,0,0,0,6,0,3,0,3
5561,2020-02-01,Newcastle,Norwich,0,0,D,2020-02-01,0,0,0,0,0,0,1,1,0
5562,2020-02-01,Watford,Everton,2,3,A,2020-02-01,2,3,3,3,-1,0,0,3,-3
5563,2020-02-01,West Ham,Brighton,3,3,D,2020-02-01,3,3,5,5,-2,-2,1,1,0
5564,2020-02-01,Man United,Wolves,0,0,D,2020-02-01,0,0,0,0,0,0,1,1,0
5565,2020-02-02,Burnley,Arsenal,0,0,D,2020-02-08,0,0,0,0,0,0,1,1,0
5566,2020-02-02,Tottenham,Man City,2,0,H,2020-02-08,2,0,0,0,2,0,3,0,3
5567,2020-02-08,Everton,Crystal Palace,3,1,H,2020-02-08,3,1,1,1,2,0,3,0,3
5568,2020-02-08,Brighton,Watford,1,1,D,2020-02-08,1,1,1,1,0,0,1,1,0
5569,2020-02-09,Sheffield United,Bournemouth,2,1,H,2020-02-15,2,1,1,1,1,0,3,0,3
5570,2020-02-14,Wolves,Leicester,0,0,D,2020-02-15,0,0,0,0,0,0,1,1,0
5571,2020-02-15,Southampton,Burnley,1,2,A,2020-02-15,1,2,2,2,-1,0,0,3,-3
5572,2020-02-15,Norwich,Liverpool,0,1,A,2020-02-15,0,1,1,1,-1,0,0,3,-3
5573,2020-02-16,Aston Villa,Tottenham,2,3,A,2020-02-22,2,4,5,5,-3,-1,0,3,-3
5574,2020-02-16,Arsenal,Newcastle,4,0,H,2020-02-22,4,0,0,0,4,0,3,0,3
5575,2020-02-17,Chelsea,Man United,0,2,A,2020-02-22,2,2,3,3,-1,-1,3,3,0
5576,2020-02-19,Man City,West Ham,2,0,H,2020-02-22,3,0,0,0,3,0,3,0,3
5577,2020-02-22,Chelsea,Tottenham,2,1,H,2020-02-22,2,4,3,3,-1,1,3,3,0
5578,2020-02-22,Burnley,Bournemouth,3,0,H,2020-02-22,3,0,0,0,3,0,3,0,3
5579,2020-02-22,Crystal Palace,Newcastle,1,0,H,2020-02-22,1,0,0,0,1,0,3,0,3
5580,2020-02-22,Sheffield United,Brighton,1,1,D,2020-02-22,1,1,1,1,0,0,1,1,0
5581,2020-02-22,Southampton,Aston Villa,2,0,H,2020-02-22,2,2,0,0,2,2,3,0,3
5582,2020-02-22,Leicester,Man City,0,1,A,2020-02-22,0,3,1,1,-1,2,0,3,-3
5583,2020-02-23,Man United,Watford,3,0,H,2020-02-29,3,3,0,0,3,3,3,0,3
5584,2020-02-23,Wolves,Norwich,3,0,H,2020-02-29,3,1,0,0,3,1,3,0,3
5585,2020-02-23,Arsenal,Everton,3,2,H,2020-02-29,3,2,2,2,1,0,3,0,3
5586,2020-02-24,Liverpool,West Ham,3,2,H,2020-02-29,3,5,5,5,-2,0,3,0,3
5587,2020-02-28,Norwich,Leicester,1,0,H,2020-02-29,1,0,3,3,-2,-3,3,0,3
5588,2020-02-29,Brighton,Crystal Palace,0,1,A,2020-02-29,0,1,1,1,-1,0,0,3,-3
5589,2020-02-29,Bournemouth,Chelsea,2,2,D,2020-02-29,2,2,2,2,0,0,1,1,0
5590,2020-02-29,Newcastle,Burnley,0,0,D,2020-02-29,0,0,0,0,0,0,1,1,0
5591,2020-02-29,West Ham,Southampton,3,1,H,2020-02-29,5,1,4,4,1,-3,3,0,3
5592,2020-02-29,Watford,Liverpool,3,0,H,2020-02-29,3,3,3,3,0,0,3,0,3
5593,2020-03-01,Everton,Man United,1,1,D,2020-03-07,1,1,1,1,0,0,1,1,0
5594,2020-03-01,Tottenham,Wolves,2,3,A,2020-03-07,3,3,4,4,-1,-1,0,3,-3
5595,2020-03-07,Liverpool,Bournemouth,2,1,H,2020-03-07,2,1,1,1,1,0,3,0,3
5596,2020-03-07,Arsenal,West Ham,1,0,H,2020-03-07,1,0,0,0,1,0,3,0,3
5597,2020-03-07,Crystal Palace,Watford,1,0,H,2020-03-07,1,0,0,0,1,0,3,0,3
5598,2020-03-07,Sheffield United,Norwich,1,0,H,2020-03-07,1,0,0,0,1,0,3,0,3
5599,2020-03-07,Southampton,Newcastle,0,1,A,2020-03-07,0,1,1,1,-1,0,0,3,-3
5600,2020-03-07,Wolves,Brighton,0,0,D,2020-03-07,3,0,2,2,1,-2,1,1,0
5601,2020-03-07,Burnley,Tottenham,1,1,D,2020-03-07,1,3,1,1,0,2,1,1,0
5602,2020-03-08,Chelsea,Everton,4,0,H,2020-03-14,4,0,0,0,4,0,3,0,3
5603,2020-03-08,Man United,Man City,2,0,H,2020-03-14,2,0,0,0,2,0,3,0,3
5604,2020-03-09,Leicester,Aston Villa,4,0,H,2020-03-14,4,0,0,0,4,0,3,0,3
5605,2020-06-17,Aston Villa,Sheffield United,0,0,D,2020-06-20,0,0,0,0,0,0,1,1,0
5606,2020-06-17,Man City,Arsenal,3,0,H,2020-06-20,3,1,0,0,3,1,3,0,3
5607,2020-06-19,Norwich,Southampton,0,3,A,2020-06-20,0,3,3,3,-3,0,0,3,-3
5608,2020-06-19,Tottenham,Man United,1,1,D,2020-06-20,1,1,1,1,0,0,1,1,0
5609,2020-06-20,Watford,Leicester,1,1,D,2020-06-20,1,1,1,1,0,0,1,1,0
5610,2020-06-20,Brighton,Arsenal,2,1,H,2020-06-20,2,1,1,1,1,0,3,0,3
5611,2020-06-20,West Ham,Wolves,0,2,A,2020-06-20,0,2,2,2,-2,0,0,3,-3
5612,2020-06-20,Bournemouth,Crystal Palace,0,2,A,2020-06-20,0,2,2,2,-2,0,0,3,-3
5613,2020-06-21,Newcastle,Sheffield United,3,0,H,2020-06-27,4,0,1,1,3,-1,4,0,4
5614,2020-06-21,Aston Villa,Chelsea,1,2,A,2020-06-27,2,4,4,4,-2,0,0,3,-3
5615,2020-06-21,Everton,Liverpool,0,0,D,2020-06-27,1,4,0,0,1,4,1,1,0
5616,2020-06-22,Man City,Burnley,5,0,H,2020-06-27,6,1,2,2,4,-1,3,0,3
5617,2020-06-23,Leicester,Brighton,0,0,D,2020-06-27,0,0,0,0,0,0,1,1,0
5618,2020-06-23,Tottenham,West Ham,2,0,H,2020-06-27,2,0,0,0,2,0,3,0,3
5619,2020-06-24,Man United,Sheffield United,3,0,H,2020-06-27,3,0,0,0,3,0,3,0,3
5620,2020-06-24,Newcastle,Aston Villa,1,1,D,2020-06-27,4,2,1,1,3,1,4,1,3
5621,2020-06-24,Norwich,Everton,0,1,A,2020-06-27,0,1,1,1,-1,0,0,3,-3
5622,2020-06-24,Wolves,Bournemouth,1,0,H,2020-06-27,2,0,0,0,2,0,3,0,3
5623,2020-06-24,Liverpool,Crystal Palace,4,0,H,2020-06-27,4,0,0,0,4,0,3,0,3
5624,2020-06-25,Burnley,Watford,1,0,H,2020-06-27,1,0,5,5,-4,-5,3,0,3
5625,2020-06-25,Southampton,Arsenal,0,2,A,2020-06-27,0,2,2,2,-2,0,0,3,-3
5626,2020-06-25,Chelsea,Man City,2,1,H,2020-06-27,4,6,2,2,2,4,3,0,3
5627,2020-06-27,Aston Villa,Wolves,0,1,A,2020-06-27,2,2,4,4,-2,-2,0,3,-3
5628,2020-06-28,Watford,Southampton,1,3,A,2020-07-04,1,3,6,6,-5,-3,0,3,-3
5629,2020-06-29,Crystal Palace,Burnley,0,1,A,2020-07-04,0,1,4,4,-4,-3,0,3,-3
5630,2020-06-30,Brighton,Man United,0,3,A,2020-07-04,1,8,3,3,-2,5,0,3,-3
5631,2020-07-01,Arsenal,Norwich,4,0,H,2020-07-04,6,0,0,0,6,0,3,0,3
5632,2020-07-01,Bournemouth,Newcastle,1,4,A,2020-07-04,3,4,9,9,-6,-5,0,3,-3
5633,2020-07-01,Everton,Leicester,2,1,H,2020-07-04,2,4,1,1,1,3,3,0,3
5634,2020-07-01,West Ham,Chelsea,3,2,H,2020-07-04,3,5,2,2,1,3,3,0,3
5635,2020-07-02,Sheffield United,Tottenham,3,1,H,2020-07-04,3,1,1,1,2,0,3,0,3
5636,2020-07-02,Man City,Liverpool,4,0,H,2020-07-04,4,0,0,0,4,0,3,0,3
5637,2020-07-04,Norwich,Brighton,0,1,A,2020-07-04,0,1,5,5,-5,-4,0,3,-3
5638,2020-07-04,Leicester,Crystal Palace,3,0,H,2020-07-04,4,0,2,2,2,-2,3,0,3
5639,2020-07-04,Man United,Bournemouth,5,2,H,2020-07-04,8,3,2,2,6,1,3,0,3
5640,2020-07-04,Wolves,Arsenal,0,2,A,2020-07-04,0,6,2,2,-2,4,0,3,-3
5641,2020-07-04,Chelsea,Watford,3,0,H,2020-07-04,5,1,3,3,2,-2,3,0,3
5642,2020-07-05,Burnley,Sheffield United,1,1,D,2020-07-11,3,5,2,2,1,3,1,1,0
5643,2020-07-05,Newcastle,West Ham,2,2,D,2020-07-11,3,6,9,9,-6,-3,1,4,-3
5644,2020-07-05,Liverpool,Aston Villa,2,0,H,2020-07-11,6,0,2,2,4,-2,4,0,4
5645,2020-07-05,Southampton,Man City,1,0,H,2020-07-11,2,10,1,1,1,9,3,3,0
5646,2020-07-06,Tottenham,Everton,1,0,H,2020-07-11,1,1,0,0,1,1,3,0,3
5647,2020-07-07,Crystal Palace,Chelsea,2,3,A,2020-07-11,2,3,3,3,-1,0,0,3,-3
5648,2020-07-07,Watford,Norwich,2,1,H,2020-07-11,4,1,2,2,2,-1,6,0,6
5649,2020-07-07,Arsenal,Leicester,1,1,D,2020-07-11,1,1,1,1,0,0,1,1,0
5650,2020-07-08,Man City,Newcastle,5,0,H,2020-07-11,10,3,1,1,9,2,3,0,3
5651,2020-07-08,Sheffield United,Wolves,1,0,H,2020-07-11,5,0,1,1,4,-1,6,0,6
5652,2020-07-08,West Ham,Burnley,0,1,A,2020-07-11,6,3,3,3,3,0,0,4,-4
5653,2020-07-08,Brighton,Liverpool,1,3,A,2020-07-11,1,6,8,8,-7,-2,0,3,-3
5654,2020-07-09,Bournemouth,Tottenham,0,0,D,2020-07-11,0,1,0,0,0,1,1,1,0
5655,2020-07-09,Everton,Southampton,1,1,D,2020-07-11,1,2,2,2,-1,0,1,1,0
5656,2020-07-09,Aston Villa,Man United,0,3,A,2020-07-11,0,3,5,5,-5,-2,0,3,-3
5657,2020-07-11,Norwich,West Ham,0,4,A,2020-07-11,1,6,6,6,-5,0,0,4,-4
5658,2020-07-11,Watford,Newcastle,2,1,H,2020-07-11,4,3,2,2,2,1,6,0,6
5659,2020-07-11,Liverpool,Burnley,1,1,D,2020-07-11,6,3,2,2,4,1,4,4,0
5660,2020-07-11,Sheffield United,Chelsea,3,0,H,2020-07-11,5,3,1,1,4,2,6,3,3
5661,2020-07-11,Brighton,Man City,0,5,A,2020-07-11,1,10,8,8,-7,2,0,3,-3
5662,2020-07-12,Wolves,Everton,3,0,H,2020-07-18,4,1,1,1,3,0,3,0,3
5663,2020-07-12,Aston Villa,Crystal Palace,2,0,H,2020-07-18,3,0,1,1,2,-1,3,0,3
5664,2020-07-12,Tottenham,Arsenal,2,1,H,2020-07-18,5,3,2,2,3,1,3,0,3
5665,2020-07-12,Bournemouth,Leicester,4,1,H,2020-07-18,5,3,3,3,2,0,3,0,3
5666,2020-07-13,Man United,Southampton,2,2,D,2020-07-18,4,3,2,2,2,1,1,1,0
5667,2020-07-14,Chelsea,Norwich,1,0,H,2020-07-18,1,0,0,0,1,0,3,0,3
5668,2020-07-15,Burnley,Wolves,1,1,D,2020-07-18,3,4,1,1,2,3,1,1,0
5669,2020-07-15,Man City,Bournemouth,2,1,H,2020-07-18,2,5,1,1,1,4,3,0,3
5670,2020-07-15,Newcastle,Tottenham,1,3,A,2020-07-18,1,5,3,3,-2,2,0,3,-3
5671,2020-07-15,Arsenal,Liverpool,2,1,H,2020-07-18,3,1,3,3,0,-2,3,0,3
5672,2020-07-16,Everton,Aston Villa,1,1,D,2020-07-18,1,3,4,4,-3,-1,1,1,0
5673,2020-07-16,Leicester,Sheffield United,2,0,H,2020-07-18,3,0,4,4,-1,-4,3,0,3
5674,2020-07-16,Crystal Palace,Man United,0,2,A,2020-07-18,0,4,4,4,-4,0,0,3,-3
5675,2020-07-16,Southampton,Brighton,1,1,D,2020-07-18,3,1,3,3,0,-2,1,1,0
5676,2020-07-17,West Ham,Watford,3,1,H,2020-07-18,3,1,1,1,2,0,3,0,3
5677,2020-07-18,Norwich,Burnley,0,2,A,2020-07-18,0,3,3,3,-3,0,0,3,-3
5678,2020-07-19,Bournemouth,Southampton,0,2,A,2020-07-25,0,2,2,2,-2,0,0,3,-3
5679,2020-07-19,Tottenham,Leicester,3,0,H,2020-07-25,3,0,0,0,3,0,3,0,3
5680,2020-07-20,Brighton,Newcastle,0,0,D,2020-07-25,0,0,0,0,0,0,1,1,0
5681,2020-07-20,Sheffield United,Everton,0,1,A,2020-07-25,0,1,1,1,-1,0,0,3,-3
5682,2020-07-20,Wolves,Crystal Palace,2,0,H,2020-07-25,2,0,0,0,2,0,3,0,3
5683,2020-07-21,Watford,Man City,0,4,A,2020-07-25,0,4,4,4,-4,0,0,3,-3
5684,2020-07-21,Aston Villa,Arsenal,1,0,H,2020-07-25,1,0,0,0,1,0,3,0,3
5685,2020-07-22,Man United,West Ham,1,1,D,2020-07-25,1,1,1,1,0,0,1,1,0
5686,2020-07-22,Liverpool,Chelsea,5,3,H,2020-07-25,5,3,3,3,2,0,3,0,3
5687,2020-07-26,Arsenal,Watford,3,2,H,2020-08-01,3,2,2,2,1,0,3,0,3
5688,2020-07-26,Burnley,Brighton,1,2,A,2020-08-01,1,2,2,2,-1,0,0,3,-3
5689,2020-07-26,Chelsea,Wolves,2,0,H,2020-08-01,2,0,0,0,2,0,3,0,3
5690,2020-07-26,Crystal Palace,Tottenham,1,1,D,2020-08-01,1,1,1,1,0,0,1,1,0
5691,2020-07-26,Everton,Bournemouth,1,3,A,2020-08-01,1,3,3,3,-2,0,0,3,-3
5692,2020-07-26,Leicester,Man United,0,2,A,2020-08-01,0,2,2,2,-2,0,0,3,-3
5693,2020-07-26,Man City,Norwich,5,0,H,2020-08-01,5,0,0,0,5,0,3,0,3
5694,2020-07-26,Newcastle,Liverpool,1,3,A,2020-08-01,1,3,3,3,-2,0,0,3,-3
5695,2020-07-26,Southampton,Sheffield United,3,1,H,2020-08-01,3,1,1,1,2,0,3,0,3
5696,2020-07-26,West Ham,Aston Villa,1,1,D,2020-08-01,1,1,1,1,0,0,1,1,0
5697,2020-09-12,Fulham,Arsenal,0,3,A,2020-09-12,0,3,3,3,-3,0,0,3,-3
5698,2020-09-12,Crystal Palace,Southampton,1,0,H,2020-09-12,1,0,0,0,1,0,3,0,3
5699,2020-09-12,Liverpool,Leeds,4,3,H,2020-09-12,4,3,3,3,1,0,3,0,3
5700,2020-09-12,West Ham,Newcastle,0,2,A,2020-09-12,0,2,2,2,-2,0,0,3,-3
5701,2020-09-13,West Brom,Leicester,0,3,A,2020-09-19,2,3,8,8,-6,-5,0,3,-3
5702,2020-09-13,Tottenham,Everton,0,1,A,2020-09-19,0,6,1,1,-1,5,0,3,-3
5703,2020-09-14,Brighton,Chelsea,1,3,A,2020-09-19,1,3,3,3,-2,0,0,3,-3
5704,2020-09-14,Sheffield United,Wolves,0,2,A,2020-09-19,0,2,2,2,-2,0,0,3,-3
5705,2020-09-19,Everton,West Brom,5,2,H,2020-09-19,6,2,2,2,4,0,3,0,3
5706,2020-09-19,Leeds,Fulham,4,3,H,2020-09-19,4,3,3,3,1,0,3,0,3
5707,2020-09-19,Man United,Crystal Palace,1,3,A,2020-09-19,1,3,3,3,-2,0,0,3,-3
5708,2020-09-19,Arsenal,West Ham,2,1,H,2020-09-19,2,1,1,1,1,0,3,0,3
5709,2020-09-20,Southampton,Tottenham,2,5,A,2020-09-26,3,5,5,5,-2,0,0,3,-3
5710,2020-09-20,Newcastle,Brighton,0,3,A,2020-09-26,0,5,3,3,-3,2,0,3,-3
5711,2020-09-20,Chelsea,Liverpool,0,2,A,2020-09-26,3,2,5,5,-2,-3,0,3,-3
5712,2020-09-20,Leicester,Burnley,4,2,H,2020-09-26,4,2,2,2,2,0,3,0,3
5713,2020-09-21,Aston Villa,Sheffield United,1,0,H,2020-09-26,1,0,0,0,1,0,3,0,3
5714,2020-09-21,Wolves,Man City,1,3,A,2020-09-26,1,3,3,3,-2,0,0,3,-3
5715,2020-09-26,Brighton,Man United,2,3,A,2020-09-26,5,3,3,3,2,0,0,3,-3
5716,2020-09-26,Crystal Palace,Everton,1,2,A,2020-09-26,1,2,2,2,-1,0,0,3,-3
5717,2020-09-26,West Brom,Chelsea,3,3,D,2020-09-26,3,3,3,3,0,0,1,1,0
5718,2020-09-26,Burnley,Southampton,0,1,A,2020-09-26,2,3,5,5,-3,-2,0,3,-3
5719,2020-09-27,Sheffield United,Leeds,0,1,A,2020-10-03,0,2,1,1,-1,1,0,3,-3
5720,2020-09-27,Tottenham,Newcastle,1,1,D,2020-10-03,1,4,1,1,0,3,1,1,0
5721,2020-09-27,Man City,Leicester,2,5,A,2020-10-03,3,5,6,6,-3,-1,0,3,-3
5722,2020-09-27,West Ham,Wolves,4,0,H,2020-10-03,4,0,0,0,4,0,3,0,3
5723,2020-09-28,Fulham,Aston Villa,0,3,A,2020-10-03,0,3,3,3,-3,0,0,3,-3
5724,2020-09-28,Liverpool,Arsenal,3,1,H,2020-10-03,3,1,1,1,2,0,3,0,3
5725,2020-10-03,Chelsea,Crystal Palace,4,0,H,2020-10-03,4,0,0,0,4,0,3,0,3
5726,2020-10-03,Everton,Brighton,4,2,H,2020-10-03,4,2,2,2,2,0,3,0,3
5727,2020-10-03,Leeds,Man City,1,1,D,2020-10-03,2,3,1,1,1,2,1,1,0
5728,2020-10-03,Newcastle,Burnley,3,1,H,2020-10-03,4,1,2,2,2,-1,3,0,3
5729,2020-10-04,Leicester,West Ham,0,3,A,2020-10-10,0,3,3,3,-3,0,0,3,-3
5730,2020-10-04,Southampton,West Brom,2,0,H,2020-10-10,2,0,0,0,2,0,3,0,3
5731,2020-10-04,Arsenal,Sheffield United,2,1,H,2020-10-10,2,1,1,1,1,0,3,0,3
5732,2020-10-04,Wolves,Fulham,1,0,H,2020-10-10,1,0,0,0,1,0,3,0,3
5733,2020-10-04,Man United,Tottenham,1,6,A,2020-10-10,1,6,6,6,-5,0,0,3,-3
5734,2020-10-04,Aston Villa,Liverpool,7,2,H,2020-10-10,7,2,2,2,5,0,3,0,3
5735,2020-10-17,Everton,Liverpool,2,2,D,2020-10-17,2,2,2,2,0,0,1,1,0
5736,2020-10-17,Chelsea,Southampton,3,3,D,2020-10-17,3,3,3,3,0,0,1,1,0
5737,2020-10-17,Man City,Arsenal,1,0,H,2020-10-17,1,0,0,0,1,0,3,0,3
5738,2020-10-17,Newcastle,Man United,1,4,A,2020-10-17,1,4,4,4,-3,0,0,3,-3
5739,2020-10-18,Sheffield United,Fulham,1,1,D,2020-10-24,2,2,3,3,-1,-1,1,1,0
5740,2020-10-18,Crystal Palace,Brighton,1,1,D,2020-10-24,3,1,2,2,1,-1,1,1,0
5741,2020-10-18,Tottenham,West Ham,3,3,D,2020-10-24,3,4,3,3,0,1,1,1,0
5742,2020-10-18,Leicester,Aston Villa,0,1,A,2020-10-24,0,1,1,1,-1,0,0,3,-3
5743,2020-10-19,West Brom,Burnley,0,0,D,2020-10-24,0,0,0,0,0,0,1,1,0
5744,2020-10-19,Leeds,Wolves,0,1,A,2020-10-24,3,1,1,1,2,0,0,3,-3
5745,2020-10-23,Aston Villa,Leeds,0,3,A,2020-10-24,1,3,3,3,-2,0,0,3,-3
5746,2020-10-24,West Ham,Man City,1,1,D,2020-10-24,4,1,4,4,0,-3,1,1,0
5747,2020-10-24,Fulham,Crystal Palace,1,2,A,2020-10-24,2,3,3,3,-1,0,0,3,-3
5748,2020-10-24,Man United,Chelsea,0,0,D,2020-10-24,0,0,0,0,0,0,1,1,0
5749,2020-10-24,Liverpool,Sheffield United,2,1,H,2020-10-24,2,2,1,1,1,1,3,0,3
5750,2020-10-25,Southampton,Everton,2,0,H,2020-10-31,2,0,0,0,2,0,3,0,3
5751,2020-10-25,Wolves,Newcastle,1,1,D,2020-10-31,3,1,1,1,2,0,4,1,3
5752,2020-10-25,Arsenal,Leicester,0,1,A,2020-10-31,0,1,1,1,-1,0,0,3,-3
5753,2020-10-26,Brighton,West Brom,1,1,D,2020-10-31,1,1,1,1,0,0,1,1,0
5754,2020-10-26,Burnley,Tottenham,0,1,A,2020-10-31,0,1,4,4,-4,-3,0,3,-3
5755,2020-10-30,Wolves,Crystal Palace,2,0,H,2020-10-31,3,0,1,1,2,-1,4,0,4
5756,2020-10-31,Sheffield United,Man City,0,1,A,2020-10-31,0,1,1,1,-1,0,0,3,-3
5757,2020-10-31,Burnley,Chelsea,0,3,A,2020-10-31,0,3,4,4,-4,-1,0,3,-3
5758,2020-10-31,Liverpool,West Ham,2,1,H,2020-10-31,2,1,1,1,1,0,3,0,3
5759,2020-11-01,Aston Villa,Southampton,3,4,A,2020-11-07,3,6,4,4,-1,2,0,3,-3
5760,2020-11-01,Newcastle,Everton,2,1,H,2020-11-07,2,2,3,3,-1,-1,3,0,3
5761,2020-11-01,Man United,Arsenal,0,1,A,2020-11-07,3,1,2,2,1,-1,0,3,-3
5762,2020-11-01,Tottenham,Brighton,2,1,H,2020-11-07,2,1,1,1,1,0,3,0,3
5763,2020-11-02,Fulham,West Brom,2,0,H,2020-11-07,2,0,1,1,1,-1,3,0,3
5764,2020-11-02,Leeds,Leicester,1,4,A,2020-11-07,2,4,8,8,-6,-4,0,3,-3
5765,2020-11-06,Brighton,Burnley,0,0,D,2020-11-07,1,0,2,2,-1,-2,1,1,0
5766,2020-11-06,Southampton,Newcastle,2,0,H,2020-11-07,6,2,3,3,3,-1,3,0,3
5767,2020-11-07,Everton,Man United,1,3,A,2020-11-07,2,3,5,5,-3,-2,0,3,-3
5768,2020-11-07,Crystal Palace,Leeds,4,1,H,2020-11-07,4,2,1,1,3,1,3,0,3
5769,2020-11-07,Chelsea,Sheffield United,4,1,H,2020-11-07,4,1,1,1,3,0,3,0,3
5770,2020-11-07,West Ham,Fulham,1,0,H,2020-11-07,1,2,0,0,1,2,3,0,3
5771,2020-11-08,West Brom,Tottenham,0,1,A,2020-11-14,0,1,1,1,-1,0,0,3,-3
5772,2020-11-08,Leicester,Wolves,1,0,H,2020-11-14,1,0,0,0,1,0,3,0,3
5773,2020-11-08,Man City,Liverpool,1,1,D,2020-11-14,1,1,1,1,0,0,1,1,0
5774,2020-11-08,Arsenal,Aston Villa,0,3,A,2020-11-14,0,3,3,3,-3,0,0,3,-3
5775,2020-11-21,Newcastle,Chelsea,0,2,A,2020-11-21,0,2,2,2,-2,0,0,3,-3
5776,2020-11-21,Aston Villa,Brighton,1,2,A,2020-11-21,1,2,2,2,-1,0,0,3,-3
5777,2020-11-21,Tottenham,Man City,2,0,H,2020-11-21,2,0,0,0,2,0,3,0,3
5778,2020-11-21,Man United,West Brom,1,0,H,2020-11-21,1,0,0,0,1,0,3,0,3
5779,2020-11-22,Fulham,Everton,2,3,A,2020-11-28,2,3,3,3,-1,0,0,3,-3
5780,2020-11-22,Sheffield United,West Ham,0,1,A,2020-11-28,0,1,2,2,-2,-1,0,3,-3
5781,2020-11-22,Leeds,Arsenal,0,0,D,2020-11-28,1,0,0,0,1,0,1,1,0
5782,2020-11-22,Liverpool,Leicester,3,0,H,2020-11-28,4,0,1,1,3,-1,3,0,3
5783,2020-11-23,Burnley,Crystal Palace,1,0,H,2020-11-28,1,0,5,5,-4,-5,3,0,3
5784,2020-11-23,Wolves,Southampton,1,1,D,2020-11-28,1,1,1,1,0,0,1,1,0
5785,2020-11-27,Crystal Palace,Newcastle,0,2,A,2020-11-28,0,2,3,3,-3,-1,0,3,-3
5786,2020-11-28,Brighton,Liverpool,1,1,D,2020-11-28,1,4,1,1,0,3,1,1,0
5787,2020-11-28,Man City,Burnley,5,0,H,2020-11-28,5,1,0,0,5,1,3,0,3
5788,2020-11-28,Everton,Leeds,0,1,A,2020-11-28,3,1,3,3,0,-2,0,3,-3
5789,2020-11-28,West Brom,Sheffield United,1,0,H,2020-11-28,1,0,0,0,1,0,3,0,3
5790,2020-11-29,Southampton,Man United,2,3,A,2020-12-05,2,6,3,3,-1,3,0,6,-6
5791,2020-11-29,Chelsea,Tottenham,0,0,D,2020-12-05,3,0,1,1,2,-1,4,1,3
5792,2020-11-29,Arsenal,Wolves,1,2,A,2020-12-05,1,2,2,2,-1,0,0,3,-3
5793,2020-11-30,Leicester,Fulham,1,2,A,2020-12-05,1,2,2,2,-1,0,0,3,-3
5794,2020-11-30,West Ham,Aston Villa,2,1,H,2020-12-05,3,1,4,4,-1,-3,3,0,3
5795,2020-12-05,Burnley,Everton,1,1,D,2020-12-05,1,1,1,1,0,0,1,1,0
5796,2020-12-05,Man City,Fulham,2,0,H,2020-12-05,2,2,0,0,2,2,3,3,0
5797,2020-12-05,West Ham,Man United,1,3,A,2020-12-05,3,6,4,4,-1,2,3,6,-3
5798,2020-12-05,Chelsea,Leeds,3,1,H,2020-12-05,3,1,1,1,2,0,4,0,4
5799,2020-12-06,West Brom,Crystal Palace,1,5,A,2020-12-12,2,5,7,7,-5,-2,0,3,-3
5800,2020-12-06,Sheffield United,Leicester,1,2,A,2020-12-12,1,2,2,2,-1,0,0,3,-3
5801,2020-12-06,Tottenham,Arsenal,2,0,H,2020-12-12,2,0,0,0,2,0,3,0,3
5802,2020-12-06,Liverpool,Wolves,4,0,H,2020-12-12,4,0,0,0,4,0,3,0,3
5803,2020-12-07,Brighton,Southampton,1,2,A,2020-12-12,1,2,2,2,-1,0,0,3,-3
5804,2020-12-11,Leeds,West Ham,1,2,A,2020-12-12,1,2,2,2,-1,0,0,3,-3
5805,2020-12-12,Wolves,Aston Villa,0,1,A,2020-12-12,0,1,5,5,-5,-4,0,3,-3
5806,2020-12-12,Newcastle,West Brom,2,1,H,2020-12-12,2,2,1,1,1,1,3,0,3
5807,2020-12-12,Man United,Man City,0,0,D,2020-12-12,0,0,0,0,0,0,1,1,0
5808,2020-12-12,Everton,Chelsea,1,0,H,2020-12-12,1,0,0,0,1,0,3,0,3
5809,2020-12-13,Southampton,Sheffield United,3,0,H,2020-12-19,4,2,2,2,2,0,3,0,3
5810,2020-12-13,Crystal Palace,Tottenham,1,1,D,2020-12-19,2,2,9,9,-7,-7,1,1,0
5811,2020-12-13,Fulham,Liverpool,1,1,D,2020-12-19,2,10,2,2,0,8,2,4,-2
5812,2020-12-13,Arsenal,Burnley,0,1,A,2020-12-19,2,1,4,4,-2,-3,1,4,-3
5813,2020-12-13,Leicester,Brighton,3,0,H,2020-12-19,3,0,2,2,1,-2,3,1,2
5814,2020-12-15,Wolves,Chelsea,2,1,H,2020-12-19,2,1,1,1,1,0,3,0,3
5815,2020-12-15,Man City,West Brom,1,1,D,2020-12-19,2,1,1,1,1,0,1,1,0
5816,2020-12-16,Arsenal,Southampton,1,1,D,2020-12-19,2,4,4,4,-2,0,1,1,0
5817,2020-12-16,Leeds,Newcastle,5,2,H,2020-12-19,5,3,2,2,3,1,3,0,3
5818,2020-12-16,Leicester,Everton,0,2,A,2020-12-19,3,4,2,2,1,2,3,3,0
5819,2020-12-16,Fulham,Brighton,0,0,D,2020-12-19,2,0,2,2,0,-2,2,1,1
5820,2020-12-16,Liverpool,Tottenham,2,1,H,2020-12-19,10,2,2,2,8,0,3,1,2
5821,2020-12-16,West Ham,Crystal Palace,1,1,D,2020-12-19,1,2,1,1,0,1,1,1,0
5822,2020-12-17,Aston Villa,Burnley,0,0,D,2020-12-19,0,1,0,0,0,1,1,4,-3
5823,2020-12-17,Sheffield United,Man United,2,3,A,2020-12-19,2,3,6,6,-4,-3,0,3,-3
5824,2020-12-19,Crystal Palace,Liverpool,0,7,A,2020-12-19,2,10,9,9,-7,1,1,4,-3
5825,2020-12-19,Southampton,Man City,0,1,A,2020-12-19,4,2,2,2,2,0,3,3,0
5826,2020-12-19,Everton,Arsenal,2,1,H,2020-12-19,4,2,1,1,3,1,3,0,3
5827,2020-12-19,Newcastle,Fulham,1,1,D,2020-12-19,3,2,6,6,-3,-4,1,1,0
5828,2020-12-20,Brighton,Sheffield United,1,1,D,2020-12-26,1,1,1,1,0,0,1,1,0
5829,2020-12-20,Tottenham,Leicester,0,2,A,2020-12-26,0,4,2,2,-2,2,0,3,-3
5830,2020-12-20,Man United,Leeds,6,2,H,2020-12-26,8,2,4,4,4,-2,3,0,3
5831,2020-12-20,West Brom,Aston Villa,0,3,A,2020-12-26,0,6,3,3,-3,3,0,3,-3
5832,2020-12-21,Burnley,Wolves,2,1,H,2020-12-26,2,1,1,1,1,0,3,0,3
5833,2020-12-21,Chelsea,West Ham,3,0,H,2020-12-26,4,0,3,3,1,-3,3,0,3
5834,2020-12-26,Leicester,Man United,2,2,D,2020-12-26,4,8,2,2,2,6,1,1,0
5835,2020-12-26,Aston Villa,Crystal Palace,3,0,H,2020-12-26,6,0,0,0,6,0,3,0,3
5836,2020-12-26,Fulham,Southampton,0,0,D,2020-12-26,0,0,0,0,0,0,1,1,0
5837,2020-12-26,Arsenal,Chelsea,3,1,H,2020-12-26,3,4,1,1,2,3,3,0,3
5838,2020-12-26,Man City,Newcastle,2,0,H,2020-12-26,2,0,0,0,2,0,3,0,3
5839,2020-12-26,Sheffield United,Everton,0,1,A,2020-12-26,1,1,2,2,-1,-1,0,3,-3
5840,2020-12-27,Leeds,Burnley,1,0,H,2021-01-02,6,1,3,3,3,-2,3,0,3
5841,2020-12-27,West Ham,Brighton,2,2,D,2021-01-02,3,5,2,2,1,3,1,1,0
5842,2020-12-27,Liverpool,West Brom,1,1,D,2021-01-02,1,1,1,1,0,0,1,1,0
5843,2020-12-27,Wolves,Tottenham,1,1,D,2021-01-02,4,4,5,5,-1,-1,1,1,0
5844,2020-12-28,Crystal Palace,Leicester,1,1,D,2021-01-02,3,1,1,1,2,0,4,1,3
5845,2020-12-28,Chelsea,Aston Villa,1,1,D,2021-01-02,1,2,1,1,0,1,1,1,0
5846,2020-12-29,Brighton,Arsenal,0,1,A,2021-01-02,5,5,6,6,-1,-1,1,6,-5
5847,2020-12-29,Burnley,Sheffield United,1,0,H,2021-01-02,1,0,1,1,0,-1,3,0,3
5848,2020-12-29,Southampton,West Ham,0,0,D,2021-01-02,0,3,0,0,0,3,1,4,-3
5849,2020-12-29,West Brom,Leeds,0,5,A,2021-01-02,1,6,10,10,-9,-4,0,3,-3
5850,2020-12-29,Man United,Wolves,1,0,H,2021-01-02,3,4,1,1,2,3,6,1,5
5851,2020-12-30,Newcastle,Liverpool,0,0,D,2021-01-02,0,1,0,0,0,1,1,1,0
5852,2021-01-01,Everton,West Ham,0,1,A,2021-01-02,0,3,1,1,-1,2,0,4,-4
5853,2021-01-01,Man United,Aston Villa,2,1,H,2021-01-02,3,2,1,1,2,1,6,1,5
5854,2021-01-02,Tottenham,Leeds,3,0,H,2021-01-02,4,6,1,1,3,5,3,3,0
5855,2021-01-02,Crystal Palace,Sheffield United,2,0,H,2021-01-02,3,0,1,1,2,-1,4,0,4
5856,2021-01-02,Brighton,Wolves,3,3,D,2021-01-02,5,4,6,6,-1,-2,1,1,0
5857,2021-01-02,West Brom,Arsenal,0,4,A,2021-01-02,1,5,10,10,-9,-5,0,6,-6
5858,2021-01-03,Newcastle,Leicester,1,2,A,2021-01-09,1,2,2,2,-1,0,0,3,-3
5859,2021-01-03,Chelsea,Man City,1,3,A,2021-01-09,1,3,3,3,-2,0,0,3,-3
5860,2021-01-04,Southampton,Liverpool,1,0,H,2021-01-09,1,0,0,0,1,0,3,0,3
5861,2021-01-12,Sheffield United,Newcastle,1,0,H,2021-01-16,1,0,0,0,1,0,3,0,3
5862,2021-01-12,Burnley,Man United,0,1,A,2021-01-16,0,1,2,2,-2,-1,0,3,-3
5863,2021-01-12,Wolves,Everton,1,2,A,2021-01-16,3,2,5,5,-2,-3,0,3,-3
5864,2021-01-13,Man City,Brighton,1,0,H,2021-01-16,1,1,0,0,1,1,3,3,0
5865,2021-01-13,Tottenham,Fulham,1,1,D,2021-01-16,1,1,1,1,0,0,1,1,0
5866,2021-01-14,Arsenal,Crystal Palace,0,0,D,2021-01-16,0,0,0,0,0,0,1,1,0
5867,2021-01-16,Wolves,West Brom,2,3,A,2021-01-16,3,3,5,5,-2,-2,0,3,-3
5868,2021-01-16,Leeds,Brighton,0,1,A,2021-01-16,0,1,1,1,-1,0,0,3,-3
5869,2021-01-16,West Ham,Burnley,1,0,H,2021-01-16,1,0,0,0,1,0,3,0,3
5870,2021-01-16,Fulham,Chelsea,0,1,A,2021-01-16,1,1,2,2,-1,-1,0,3,-3
5871,2021-01-16,Leicester,Southampton,2,0,H,2021-01-16,2,0,0,0,2,0,3,0,3
5872,2021-01-17,Sheffield United,Tottenham,1,3,A,2021-01-23,1,3,3,3,-2,0,0,3,-3
5873,2021-01-17,Liverpool,Man United,0,0,D,2021-01-23,0,2,1,1,-1,1,1,4,-3
5874,2021-01-17,Man City,Crystal Palace,4,0,H,2021-01-23,6,0,0,0,6,0,6,0,6
5875,2021-01-18,Arsenal,Newcastle,3,0,H,2021-01-23,3,0,0,0,3,0,3,0,3
5876,2021-01-19,West Ham,West Brom,2,1,H,2021-01-23,2,1,1,1,1,0,3,0,3
5877,2021-01-19,Leicester,Chelsea,2,0,H,2021-01-23,2,0,0,0,2,0,3,0,3
5878,2021-01-20,Man City,Aston Villa,2,0,H,2021-01-23,6,2,0,0,6,2,6,0,6
5879,2021-01-20,Fulham,Man United,1,2,A,2021-01-23,1,2,2,2,-1,0,0,4,-4
5880,2021-01-21,Liverpool,Burnley,0,1,A,2021-01-23,0,1,1,1,-1,0,1,3,-2
5881,2021-01-23,Aston Villa,Newcastle,2,0,H,2021-01-23,2,0,2,2,0,-2,3,0,3
5882,2021-01-26,Crystal Palace,West Ham,2,3,A,2021-01-30,3,3,3,3,0,0,3,3,0
5883,2021-01-26,Newcastle,Leeds,1,2,A,2021-01-30,3,2,2,2,1,0,0,3,-3
5884,2021-01-26,Southampton,Arsenal,1,3,A,2021-01-30,1,3,4,4,-3,-1,0,3,-3
5885,2021-01-26,West Brom,Man City,0,5,A,2021-01-30,2,6,7,7,-5,-1,1,3,-2
5886,2021-01-27,Burnley,Aston Villa,3,2,H,2021-01-30,3,3,2,2,1,1,3,3,0
5887,2021-01-27,Chelsea,Wolves,0,0,D,2021-01-30,0,0,0,0,0,0,1,1,0
5888,2021-01-27,Brighton,Fulham,0,0,D,2021-01-30,0,2,0,0,0,2,1,2,-1
5889,2021-01-27,Everton,Leicester,1,1,D,2021-01-30,1,1,3,3,-2,-2,1,1,0
5890,2021-01-27,Man United,Sheffield United,1,2,A,2021-01-30,1,2,2,2,-1,0,0,3,-3
5891,2021-01-28,Tottenham,Liverpool,1,3,A,2021-01-30,1,3,3,3,-2,0,0,3,-3
5892,2021-01-30,Everton,Newcastle,0,2,A,2021-01-30,1,3,3,3,-2,0,1,3,-2
5893,2021-01-30,Crystal Palace,Wolves,1,0,H,2021-01-30,3,0,3,3,0,-3,3,1,2
5894,2021-01-30,Man City,Sheffield United,1,0,H,2021-01-30,6,2,0,0,6,2,3,3,0
5895,2021-01-30,West Brom,Fulham,2,2,D,2021-01-30,2,2,7,7,-5,-5,1,2,-1
5896,2021-01-30,Arsenal,Man United,0,0,D,2021-01-30,3,1,1,1,2,0,1,1,0
5897,2021-01-30,Southampton,Aston Villa,0,1,A,2021-01-30,1,3,4,4,-3,-1,0,3,-3
5898,2021-01-31,Chelsea,Burnley,2,0,H,2021-02-06,3,1,0,0,3,1,3,0,3
5899,2021-01-31,Leicester,Leeds,1,3,A,2021-02-06,3,4,3,3,0,1,0,3,-3
5900,2021-01-31,West Ham,Liverpool,1,3,A,2021-02-06,4,3,4,4,0,-1,0,3,-3
5901,2021-01-31,Brighton,Tottenham,1,0,H,2021-02-06,3,0,1,1,2,-1,3,0,3
5902,2021-02-02,Sheffield United,West Brom,2,1,H,2021-02-06,2,1,1,1,1,0,3,0,3
5903,2021-02-02,Wolves,Arsenal,2,1,H,2021-02-06,2,1,1,1,1,0,3,0,3
5904,2021-02-02,Man United,Southampton,9,0,H,2021-02-06,12,2,3,3,9,-1,4,0,4
5905,2021-02-02,Newcastle,Crystal Palace,1,2,A,2021-02-06,4,2,4,4,0,-2,3,3,0
5906,2021-02-03,Burnley,Man City,0,2,A,2021-02-06,1,2,5,5,-4,-3,1,3,-2
5907,2021-02-03,Fulham,Leicester,0,2,A,2021-02-06,0,3,2,2,-2,1,1,3,-2
5908,2021-02-03,Leeds,Everton,1,2,A,2021-02-06,4,5,3,3,1,2,0,4,-4
5909,2021-02-03,Aston Villa,West Ham,1,3,A,2021-02-06,2,4,3,3,-1,1,3,4,-1
5910,2021-02-03,Liverpool,Brighton,0,1,A,2021-02-06,3,3,2,2,1,1,0,4,-4
5911,2021-02-04,Tottenham,Chelsea,0,1,A,2021-02-06,0,3,2,2,-2,1,0,3,-3
5912,2021-02-06,Aston Villa,Arsenal,1,0,H,2021-02-06,2,1,3,3,-1,-2,3,0,3
5913,2021-02-06,Burnley,Brighton,1,1,D,2021-02-06,1,3,5,5,-4,-2,1,4,-3
5914,2021-02-06,Newcastle,Southampton,3,2,H,2021-02-06,4,2,4,4,0,-2,3,0,3
5915,2021-02-06,Fulham,West Ham,0,0,D,2021-02-06,0,4,2,2,-2,2,1,4,-3
5916,2021-02-06,Man United,Everton,3,3,D,2021-02-06,12,5,3,3,9,2,4,4,0
5917,2021-02-07,Tottenham,West Brom,2,0,H,2021-02-13,2,0,3,3,-1,-3,3,0,3
5918,2021-02-07,Wolves,Leicester,0,0,D,2021-02-13,0,3,0,0,0,3,1,1,0
5919,2021-02-07,Liverpool,Man City,1,4,A,2021-02-13,2,7,7,7,-5,0,0,3,-3
5920,2021-02-07,Sheffield United,Chelsea,1,2,A,2021-02-13,1,2,2,2,-1,0,0,3,-3
5921,2021-02-08,Leeds,Crystal Palace,2,0,H,2021-02-13,2,0,0,0,2,0,3,0,3
5922,2021-02-13,Leicester,Liverpool,3,1,H,2021-02-13,3,2,1,1,2,1,3,0,3
5923,2021-02-13,Crystal Palace,Burnley,0,3,A,2021-02-13,0,3,5,5,-5,-2,0,3,-3
5924,2021-02-13,Man City,Tottenham,3,0,H,2021-02-13,7,2,1,1,6,1,3,0,3
5925,2021-02-13,Brighton,Aston Villa,0,0,D,2021-02-13,0,0,0,0,0,0,1,1,0
5926,2021-02-14,Southampton,Wolves,1,2,A,2021-02-20,2,3,3,3,-1,0,1,3,-2
5927,2021-02-14,West Brom,Man United,1,1,D,2021-02-20,1,1,1,1,0,0,1,1,0
5928,2021-02-14,Arsenal,Leeds,4,2,H,2021-02-20,4,2,2,2,2,0,3,0,3
5929,2021-02-14,Everton,Fulham,0,2,A,2021-02-20,3,4,5,5,-2,-1,0,4,-4
5930,2021-02-15,West Ham,Sheffield United,3,0,H,2021-02-20,3,0,0,0,3,0,3,0,3
5931,2021-02-15,Chelsea,Newcastle,2,0,H,2021-02-20,3,0,1,1,2,-1,3,0,3
5932,2021-02-17,Burnley,Fulham,1,1,D,2021-02-20,1,4,1,1,0,3,2,4,-2
5933,2021-02-17,Everton,Man City,1,3,A,2021-02-20,3,3,5,5,-2,-2,0,3,-3
5934,2021-02-19,Wolves,Leeds,1,0,H,2021-02-20,3,2,1,1,2,1,3,0,3
5935,2021-02-20,Southampton,Chelsea,1,1,D,2021-02-20,2,3,3,3,-1,0,1,1,0
5936,2021-02-20,Burnley,West Brom,0,0,D,2021-02-20,1,1,1,1,0,0,2,1,1
5937,2021-02-20,Liverpool,Everton,0,2,A,2021-02-20,0,3,2,2,-2,1,0,3,-3
5938,2021-02-20,Fulham,Sheffield United,1,0,H,2021-02-20,4,0,1,1,3,-1,3,0,3
5939,2021-02-21,West Ham,Tottenham,2,1,H,2021-02-27,3,1,3,3,0,-2,3,0,3
5940,2021-02-21,Aston Villa,Leicester,1,2,A,2021-02-27,2,2,2,2,0,0,0,3,-3
5941,2021-02-21,Arsenal,Man City,0,1,A,2021-02-27,0,3,1,1,-1,2,0,3,-3
5942,2021-02-21,Man United,Newcastle,3,1,H,2021-02-27,3,2,1,1,2,1,3,0,3
5943,2021-02-22,Brighton,Crystal Palace,1,2,A,2021-02-27,1,2,3,3,-2,-1,0,3,-3
5944,2021-02-23,Leeds,Southampton,3,0,H,2021-02-27,3,0,1,1,2,-1,3,0,3
5945,2021-02-27,Man City,West Ham,2,1,H,2021-02-27,3,3,1,1,2,2,3,0,3
5946,2021-02-27,West Brom,Brighton,1,0,H,2021-02-27,1,1,0,0,1,1,3,0,3
5947,2021-02-27,Leeds,Aston Villa,0,1,A,2021-02-27,3,2,1,1,2,1,3,3,0
5948,2021-02-27,Newcastle,Wolves,1,1,D,2021-02-27,2,1,4,4,-2,-3,1,1,0
5949,2021-02-28,Crystal Palace,Fulham,0,0,D,2021-03-06,0,0,0,0,0,0,2,1,1
5950,2021-02-28,Leicester,Arsenal,1,3,A,2021-03-06,4,4,5,5,-1,-1,0,4,-4
5951,2021-02-28,Tottenham,Burnley,4,0,H,2021-03-06,5,2,0,0,5,2,3,0,3
5952,2021-02-28,Chelsea,Man United,0,0,D,2021-03-06,1,0,0,0,1,0,1,2,-1
5953,2021-02-28,Sheffield United,Liverpool,0,2,A,2021-03-06,1,2,4,4,-3,-2,3,3,0
5954,2021-03-01,Everton,Southampton,1,0,H,2021-03-06,2,2,0,0,2,2,3,3,0
5955,2021-03-02,Man City,Wolves,4,1,H,2021-03-06,4,1,1,1,3,0,3,1,2
5956,2021-03-03,Burnley,Leicester,1,1,D,2021-03-06,2,4,6,6,-4,-2,2,4,-2
5957,2021-03-03,Sheffield United,Aston Villa,1,0,H,2021-03-06,1,0,4,4,-3,-4,3,0,3
5958,2021-03-03,Crystal Palace,Man United,0,0,D,2021-03-06,0,0,0,0,0,0,2,2,0
5959,2021-03-04,Fulham,Tottenham,0,1,A,2021-03-06,0,5,1,1,-1,4,0,3,-3
5960,2021-03-04,West Brom,Everton,0,1,A,2021-03-06,0,2,1,1,-1,1,0,3,-3
5961,2021-03-04,Liverpool,Chelsea,0,1,A,2021-03-06,2,1,1,1,1,0,0,3,-3
5962,2021-03-06,Burnley,Arsenal,1,1,D,2021-03-06,2,4,6,6,-4,-2,2,4,-2
5963,2021-03-06,Sheffield United,Southampton,0,2,A,2021-03-06,1,2,4,4,-3,-2,3,3,0
5964,2021-03-06,Aston Villa,Wolves,0,0,D,2021-03-06,0,1,1,1,-1,0,1,1,0
5965,2021-03-06,Brighton,Leicester,1,2,A,2021-03-06,1,4,2,2,-1,2,0,4,-4
5966,2021-03-07,West Brom,Newcastle,0,0,D,2021-03-13,0,1,1,1,-1,0,1,1,0
5967,2021-03-07,Liverpool,Fulham,0,1,A,2021-03-13,0,1,1,1,-1,0,0,3,-3
5968,2021-03-07,Man City,Man United,0,2,A,2021-03-13,8,2,4,4,4,-2,3,3,0
5969,2021-03-07,Tottenham,Crystal Palace,4,1,H,2021-03-13,4,2,1,1,3,1,3,0,3
5970,2021-03-08,Chelsea,Everton,2,0,H,2021-03-13,2,1,0,0,2,1,3,0,3
5971,2021-03-08,West Ham,Leeds,2,0,H,2021-03-13,2,0,0,0,2,0,3,0,3
5972,2021-03-10,Man City,Southampton,5,2,H,2021-03-13,8,2,4,4,4,-2,3,0,3
5973,2021-03-12,Newcastle,Aston Villa,1,1,D,2021-03-13,1,1,1,1,0,0,1,1,0
5974,2021-03-13,Leeds,Chelsea,0,0,D,2021-03-13,0,2,2,2,-2,0,1,1,0
5975,2021-03-13,Crystal Palace,West Brom,1,0,H,2021-03-13,2,0,4,4,-2,-4,3,0,3
5976,2021-03-13,Everton,Burnley,1,2,A,2021-03-13,1,2,4,4,-3,-2,0,3,-3
5977,2021-03-13,Fulham,Man City,0,3,A,2021-03-13,1,8,3,3,-2,5,0,3,-3
5978,2021-03-14,Southampton,Brighton,1,2,A,2021-03-20,1,5,2,2,-1,3,0,3,-3
5979,2021-03-14,Leicester,Sheffield United,5,0,H,2021-03-20,5,0,0,0,5,0,3,0,3
5980,2021-03-14,Arsenal,Tottenham,2,1,H,2021-03-20,2,1,1,1,1,0,3,0,3
5981,2021-03-14,Man United,West Ham,1,0,H,2021-03-20,1,0,0,0,1,0,3,0,3
5982,2021-03-15,Wolves,Liverpool,0,1,A,2021-03-20,0,1,1,1,-1,0,0,3,-3
5983,2021-03-19,Fulham,Leeds,1,2,A,2021-03-20,1,2,2,2,-1,0,0,3,-3
5984,2021-03-20,Brighton,Newcastle,3,0,H,2021-03-20,5,0,1,1,4,-1,3,0,3
5985,2021-03-21,West Ham,Arsenal,3,3,D,2021-03-27,3,3,3,3,0,0,1,1,0
5986,2021-03-21,Aston Villa,Tottenham,0,2,A,2021-03-27,0,2,2,2,-2,0,0,3,-3
5987,2021-04-03,Chelsea,West Brom,2,5,A,2021-04-03,2,5,5,5,-3,0,0,3,-3
5988,2021-04-03,Leeds,Sheffield United,2,1,H,2021-04-03,2,1,1,1,1,0,3,0,3
5989,2021-04-03,Leicester,Man City,0,2,A,2021-04-03,0,2,2,2,-2,0,0,3,-3
5990,2021-04-03,Arsenal,Liverpool,0,3,A,2021-04-03,0,3,3,3,-3,0,0,3,-3
5991,2021-04-04,Southampton,Burnley,3,2,H,2021-04-10,3,2,2,2,1,0,3,0,3
5992,2021-04-04,Newcastle,Tottenham,2,2,D,2021-04-10,2,2,2,2,0,0,1,1,0
5993,2021-04-04,Aston Villa,Fulham,3,1,H,2021-04-10,4,1,3,3,1,-2,3,0,3
5994,2021-04-04,Man United,Brighton,2,1,H,2021-04-10,2,1,1,1,1,0,3,0,3
5995,2021-04-05,Everton,Crystal Palace,1,1,D,2021-04-10,1,2,1,1,0,1,1,1,0
5996,2021-04-05,Wolves,West Ham,2,3,A,2021-04-10,3,3,3,3,0,0,0,3,-3
5997,2021-04-09,Fulham,Wolves,0,1,A,2021-04-10,1,3,4,4,-3,-1,0,3,-3
5998,2021-04-10,Man City,Leeds,1,2,A,2021-04-10,1,2,2,2,-1,0,0,3,-3
5999,2021-04-10,Liverpool,Aston Villa,2,1,H,2021-04-10,2,4,1,1,1,3,3,0,3
6000,2021-04-10,Crystal Palace,Chelsea,1,4,A,2021-04-10,2,4,5,5,-3,-1,0,3,-3
6001,2021-04-11,Burnley,Newcastle,1,2,A,2021-04-17,1,5,2,2,-1,3,0,3,-3
6002,2021-04-11,West Ham,Leicester,3,2,H,2021-04-17,5,2,5,5,0,-3,3,0,3
6003,2021-04-11,Tottenham,Man United,1,3,A,2021-04-17,3,3,5,5,-2,-2,0,3,-3
6004,2021-04-11,Sheffield United,Arsenal,0,3,A,2021-04-17,0,3,4,4,-4,-1,0,3,-3
6005,2021-04-12,West Brom,Southampton,3,0,H,2021-04-17,3,0,0,0,3,0,3,0,3
6006,2021-04-12,Brighton,Everton,0,0,D,2021-04-17,0,2,0,0,0,2,1,1,0
6007,2021-04-16,Everton,Tottenham,2,2,D,2021-04-17,2,3,2,2,0,1,1,1,0
6008,2021-04-17,Newcastle,West Ham,3,2,H,2021-04-17,5,5,3,3,2,2,3,0,3
6009,2021-04-17,Wolves,Sheffield United,1,0,H,2021-04-17,1,0,0,0,1,0,3,0,3
6010,2021-04-18,Arsenal,Fulham,1,1,D,2021-04-24,1,1,2,2,-1,-1,1,1,0
6011,2021-04-18,Man United,Burnley,3,1,H,2021-04-24,3,1,1,1,2,0,3,0,3
6012,2021-04-19,Leeds,Liverpool,1,1,D,2021-04-24,1,2,1,1,0,1,1,1,0
6013,2021-04-20,Chelsea,Brighton,0,0,D,2021-04-24,1,0,0,0,1,0,1,1,0
6014,2021-04-21,Tottenham,Southampton,2,1,H,2021-04-24,2,1,1,1,1,0,3,0,3
6015,2021-04-21,Aston Villa,Man City,1,2,A,2021-04-24,1,2,2,2,-1,0,0,3,-3
6016,2021-04-22,Leicester,West Brom,3,0,H,2021-04-24,3,0,0,0,3,0,3,0,3
6017,2021-04-23,Arsenal,Everton,0,1,A,2021-04-24,1,1,2,2,-1,-1,1,3,-2
6018,2021-04-24,Liverpool,Newcastle,1,1,D,2021-04-24,2,1,2,2,0,-1,1,1,0
6019,2021-04-24,West Ham,Chelsea,0,1,A,2021-04-24,0,1,1,1,-1,0,0,3,-3
6020,2021-04-24,Sheffield United,Brighton,1,0,H,2021-04-24,1,0,0,0,1,0,3,1,2
6021,2021-04-25,Wolves,Burnley,0,4,A,2021-05-01,0,4,4,4,-4,0,0,3,-3
6022,2021-04-25,Leeds,Man United,0,0,D,2021-05-01,0,0,2,2,-2,-2,1,1,0
6023,2021-04-25,Aston Villa,West Brom,2,2,D,2021-05-01,4,2,3,3,1,-1,1,1,0
6024,2021-04-26,Leicester,Crystal Palace,2,1,H,2021-05-01,3,1,2,2,1,-1,3,0,3
6025,2021-04-30,Southampton,Leicester,1,1,D,2021-05-01,1,3,1,1,0,2,1,1,0
6026,2021-05-01,Crystal Palace,Man City,0,2,A,2021-05-01,1,2,4,4,-3,-2,0,3,-3
6027,2021-05-01,Brighton,Leeds,2,0,H,2021-05-01,2,0,0,0,2,0,3,0,3
6028,2021-05-01,Chelsea,Fulham,2,0,H,2021-05-01,2,0,0,0,2,0,3,0,3
6029,2021-05-01,Everton,Aston Villa,1,2,A,2021-05-01,1,4,2,2,-1,2,0,3,-3
6030,2021-05-02,Newcastle,Arsenal,0,2,A,2021-05-08,4,2,4,4,0,-2,0,3,-3
6031,2021-05-02,Tottenham,Sheffield United,4,0,H,2021-05-08,5,0,3,3,2,-3,3,0,3
6032,2021-05-03,West Brom,Wolves,1,1,D,2021-05-08,1,1,1,1,0,0,1,1,0
6033,2021-05-03,Burnley,West Ham,1,2,A,2021-05-08,1,2,2,2,-1,0,0,3,-3
6034,2021-05-07,Leicester,Newcastle,2,4,A,2021-05-08,2,4,4,4,-2,0,0,3,-3
6035,2021-05-08,Leeds,Tottenham,3,1,H,2021-05-08,3,5,1,1,2,4,3,0,3
6036,2021-05-08,Sheffield United,Crystal Palace,0,2,A,2021-05-08,0,2,6,6,-6,-4,0,3,-3
6037,2021-05-08,Man City,Chelsea,1,2,A,2021-05-08,1,2,2,2,-1,0,0,3,-3
6038,2021-05-08,Liverpool,Southampton,2,0,H,2021-05-08,2,0,0,0,2,0,3,0,3
6039,2021-05-09,Wolves,Brighton,2,1,H,2021-05-15,2,2,1,1,1,1,3,0,3
6040,2021-05-09,Aston Villa,Man United,1,3,A,2021-05-15,1,6,3,3,-2,3,1,3,-2
6041,2021-05-09,West Ham,Everton,0,1,A,2021-05-15,1,1,2,2,-1,-1,0,4,-4
6042,2021-05-09,Arsenal,West Brom,3,1,H,2021-05-15,4,1,1,1,3,0,3,0,3
6043,2021-05-10,Fulham,Burnley,0,2,A,2021-05-15,1,2,5,5,-4,-3,0,3,-3
6044,2021-05-11,Man United,Leicester,1,2,A,2021-05-15,6,2,7,7,-1,-5,0,3,-3
6045,2021-05-11,Southampton,Crystal Palace,3,1,H,2021-05-15,6,1,2,2,4,-1,6,0,6
6046,2021-05-12,Chelsea,Arsenal,0,1,A,2021-05-15,0,4,1,1,-1,3,0,3,-3
6047,2021-05-13,Aston Villa,Everton,0,0,D,2021-05-15,1,1,3,3,-2,-2,1,4,-3
6048,2021-05-13,Man United,Liverpool,2,4,A,2021-05-15,6,4,7,7,-1,-3,0,3,-3
6049,2021-05-14,Newcastle,Man City,3,4,A,2021-05-15,3,4,4,4,-1,0,0,3,-3
6050,2021-05-15,Burnley,Leeds,0,4,A,2021-05-15,2,4,4,4,-2,0,0,3,-3
6051,2021-05-15,Southampton,Fulham,3,1,H,2021-05-15,6,1,2,2,4,-1,6,0,6
6052,2021-05-15,Brighton,West Ham,1,1,D,2021-05-15,2,1,3,3,-1,-2,1,1,0
6053,2021-05-16,Crystal Palace,Aston Villa,3,2,H,2021-05-22,4,4,5,5,-1,-1,3,3,0
6054,2021-05-16,Tottenham,Wolves,2,0,H,2021-05-22,3,0,2,2,1,-2,3,0,3
6055,2021-05-16,West Brom,Liverpool,1,2,A,2021-05-22,2,5,5,5,-3,0,0,6,-6
6056,2021-05-16,Everton,Sheffield United,0,1,A,2021-05-22,1,1,1,1,0,0,3,3,0
6057,2021-05-18,Man United,Fulham,1,1,D,2021-05-22,1,1,1,1,0,0,1,1,0
6058,2021-05-18,Southampton,Leeds,0,2,A,2021-05-22,0,2,2,2,-2,0,0,3,-3
6059,2021-05-18,Brighton,Man City,3,2,H,2021-05-22,3,2,2,2,1,0,3,0,3
6060,2021-05-18,Chelsea,Leicester,2,1,H,2021-05-22,2,1,1,1,1,0,3,0,3
6061,2021-05-19,Everton,Wolves,1,0,H,2021-05-22,1,0,1,1,0,-1,3,0,3
6062,2021-05-19,Newcastle,Sheffield United,1,0,H,2021-05-22,1,1,0,0,1,1,3,3,0
6063,2021-05-19,Tottenham,Aston Villa,1,2,A,2021-05-22,3,4,2,2,1,2,3,3,0
6064,2021-05-19,Crystal Palace,Arsenal,1,3,A,2021-05-22,4,3,5,5,-1,-2,3,3,0
6065,2021-05-19,Burnley,Liverpool,0,3,A,2021-05-22,0,5,3,3,-3,2,0,6,-6
6066,2021-05-19,West Brom,West Ham,1,3,A,2021-05-22,2,3,5,5,-3,-2,0,3,-3
6067,2021-05-23,Arsenal,Brighton,2,0,H,2021-05-29,2,0,0,0,2,0,3,0,3
6068,2021-05-23,Aston Villa,Chelsea,2,1,H,2021-05-29,2,1,1,1,1,0,3,0,3
6069,2021-05-23,Fulham,Newcastle,0,2,A,2021-05-29,0,2,2,2,-2,0,0,3,-3
6070,2021-05-23,Leeds,West Brom,3,1,H,2021-05-29,3,1,1,1,2,0,3,0,3
6071,2021-05-23,Leicester,Tottenham,2,4,A,2021-05-29,2,4,4,4,-2,0,0,3,-3
6072,2021-05-23,Liverpool,Crystal Palace,2,0,H,2021-05-29,2,0,0,0,2,0,3,0,3
6073,2021-05-23,Man City,Everton,5,0,H,2021-05-29,5,0,0,0,5,0,3,0,3
6074,2021-05-23,Sheffield United,Burnley,1,0,H,2021-05-29,1,0,0,0,1,0,3,0,3
6075,2021-05-23,West Ham,Southampton,3,0,H,2021-05-29,3,0,0,0,3,0,3,0,3
6076,2021-05-23,Wolves,Man United,1,2,A,2021-05-29,1,2,2,2,-1,0,0,3,-3
6077,2021-08-13,Brentford,Arsenal,2,0,H,2021-08-14,2,0,0,0,2,0,3,0,3
6078,2021-08-14,Man United,Leeds,5,1,H,2021-08-14,5,1,1,1,4,0,3,0,3
6079,2021-08-14,Burnley,Brighton,1,2,A,2021-08-14,1,2,2,2,-1,0,0,3,-3
6080,2021-08-14,Chelsea,Crystal Palace,3,0,H,2021-08-14,3,0,0,0,3,0,3,0,3
6081,2021-08-14,Everton,Southampton,3,1,H,2021-08-14,3,1,1,1,2,0,3,0,3
6082,2021-08-14,Leicester,Wolves,1,0,H,2021-08-14,1,0,0,0,1,0,3,0,3
6083,2021-08-14,Watford,Aston Villa,3,2,H,2021-08-14,3,2,2,2,1,0,3,0,3
6084,2021-08-14,Norwich,Liverpool,0,3,A,2021-08-14,0,3,3,3,-3,0,0,3,-3
6085,2021-08-15,Newcastle,West Ham,2,4,A,2021-08-21,2,4,6,6,-4,-2,0,3,-3
6086,2021-08-15,Tottenham,Man City,1,0,H,2021-08-21,1,5,0,0,1,5,3,0,3
6087,2021-08-21,Liverpool,Burnley,2,0,H,2021-08-21,2,0,0,0,2,0,3,0,3
6088,2021-08-21,Aston Villa,Newcastle,2,0,H,2021-08-21,2,2,0,0,2,2,3,0,3
6089,2021-08-21,Crystal Palace,Brentford,0,0,D,2021-08-21,0,0,0,0,0,0,1,1,0
6090,2021-08-21,Leeds,Everton,2,2,D,2021-08-21,2,2,2,2,0,0,1,1,0
6091,2021-08-21,Man City,Norwich,5,0,H,2021-08-21,5,0,1,1,4,-1,3,0,3
6092,2021-08-21,Brighton,Watford,2,0,H,2021-08-21,2,0,0,0,2,0,3,0,3
6093,2021-08-22,Southampton,Man United,1,1,D,2021-08-28,3,1,3,3,0,-2,1,1,0
6094,2021-08-22,Wolves,Tottenham,0,1,A,2021-08-28,0,1,1,1,-1,0,0,3,-3
6095,2021-08-22,Arsenal,Chelsea,0,2,A,2021-08-28,0,3,7,7,-7,-4,0,4,-4
6096,2021-08-23,West Ham,Leicester,4,1,H,2021-08-28,6,3,3,3,3,0,4,3,1
6097,2021-08-28,Man City,Arsenal,5,0,H,2021-08-28,5,0,0,0,5,0,3,0,3
6098,2021-08-28,Aston Villa,Brentford,1,1,D,2021-08-28,1,1,1,1,0,0,1,1,0
6099,2021-08-28,Brighton,Everton,0,2,A,2021-08-28,0,2,2,2,-2,0,0,3,-3
6100,2021-08-28,Newcastle,Southampton,2,2,D,2021-08-28,2,3,2,2,0,1,1,1,0
6101,2021-08-28,Norwich,Leicester,1,2,A,2021-08-28,1,3,2,2,-1,1,0,3,-3
6102,2021-08-28,West Ham,Crystal Palace,2,2,D,2021-08-28,6,2,3,3,3,-1,4,1,3
6103,2021-08-28,Liverpool,Chelsea,1,1,D,2021-08-28,1,3,1,1,0,2,1,4,-3
6104,2021-08-29,Burnley,Leeds,1,1,D,2021-09-04,1,1,1,1,0,0,1,1,0
6105,2021-08-29,Tottenham,Watford,1,0,H,2021-09-04,1,0,0,0,1,0,3,0,3
6106,2021-08-29,Wolves,Man United,0,1,A,2021-09-04,0,1,1,1,-1,0,0,3,-3
6107,2021-09-11,Crystal Palace,Tottenham,3,0,H,2021-09-11,3,0,0,0,3,0,3,0,3
6108,2021-09-11,Arsenal,Norwich,1,0,H,2021-09-11,1,0,0,0,1,0,3,0,3
6109,2021-09-11,Brentford,Brighton,0,1,A,2021-09-11,0,1,1,1,-1,0,0,3,-3
6110,2021-09-11,Leicester,Man City,0,1,A,2021-09-11,0,1,1,1,-1,0,0,3,-3
6111,2021-09-11,Man United,Newcastle,4,1,H,2021-09-11,4,1,1,1,3,0,3,0,3
6112,2021-09-11,Southampton,West Ham,0,0,D,2021-09-11,0,0,0,0,0,0,1,1,0
6113,2021-09-11,Watford,Wolves,0,2,A,2021-09-11,0,2,2,2,-2,0,0,3,-3
6114,2021-09-11,Chelsea,Aston Villa,3,0,H,2021-09-11,3,0,0,0,3,0,3,0,3
6115,2021-09-12,Leeds,Liverpool,0,3,A,2021-09-18,1,6,4,4,-3,2,0,3,-3
6116,2021-09-13,Everton,Burnley,3,1,H,2021-09-18,3,1,4,4,-1,-3,3,0,3
6117,2021-09-17,Newcastle,Leeds,1,1,D,2021-09-18,1,1,1,1,0,0,1,1,0
6118,2021-09-18,Wolves,Brentford,0,2,A,2021-09-18,0,2,2,2,-2,0,0,3,-3
6119,2021-09-18,Burnley,Arsenal,0,1,A,2021-09-18,1,1,4,4,-3,-3,0,3,-3
6120,2021-09-18,Liverpool,Crystal Palace,3,0,H,2021-09-18,6,0,0,0,6,0,3,0,3
6121,2021-09-18,Man City,Southampton,0,0,D,2021-09-18,0,0,0,0,0,0,1,1,0
6122,2021-09-18,Norwich,Watford,1,3,A,2021-09-18,1,3,3,3,-2,0,0,3,-3
6123,2021-09-18,Aston Villa,Everton,3,0,H,2021-09-18,3,3,0,0,3,3,3,0,3
6124,2021-09-19,Brighton,Leicester,2,1,H,2021-09-25,2,3,1,1,1,2,3,0,3
6125,2021-09-19,West Ham,Man United,1,2,A,2021-09-25,3,2,3,3,0,-1,0,3,-3
6126,2021-09-19,Tottenham,Chelsea,0,3,A,2021-09-25,0,3,3,3,-3,0,0,3,-3
6127,2021-09-25,Chelsea,Man City,0,1,A,2021-09-25,3,1,1,1,2,0,0,3,-3
6128,2021-09-25,Man United,Aston Villa,0,1,A,2021-09-25,2,1,2,2,0,-1,0,3,-3
6129,2021-09-25,Everton,Norwich,2,0,H,2021-09-25,2,0,0,0,2,0,3,0,3
6130,2021-09-25,Leeds,West Ham,1,2,A,2021-09-25,1,3,2,2,-1,1,0,3,-3
6131,2021-09-25,Leicester,Burnley,2,2,D,2021-09-25,3,2,4,4,-1,-2,1,1,0
6132,2021-09-25,Watford,Newcastle,1,1,D,2021-09-25,1,1,1,1,0,0,1,1,0
6133,2021-09-25,Brentford,Liverpool,3,3,D,2021-09-25,3,3,3,3,0,0,1,1,0
6134,2021-09-26,Southampton,Wolves,0,1,A,2021-10-02,1,3,4,4,-3,-1,0,3,-3
6135,2021-09-26,Arsenal,Tottenham,3,1,H,2021-10-02,3,1,1,1,2,0,3,0,3
6136,2021-09-27,Crystal Palace,Brighton,1,1,D,2021-10-02,1,1,1,1,0,0,1,1,0
6137,2021-10-02,Man United,Everton,1,1,D,2021-10-02,1,1,1,1,0,0,1,1,0
6138,2021-10-02,Burnley,Norwich,0,0,D,2021-10-02,0,0,0,0,0,0,1,1,0
6139,2021-10-02,Chelsea,Southampton,3,1,H,2021-10-02,3,1,1,1,2,0,3,0,3
6140,2021-10-02,Leeds,Watford,1,0,H,2021-10-02,1,0,0,0,1,0,3,0,3
6141,2021-10-02,Wolves,Newcastle,2,1,H,2021-10-02,3,1,1,1,2,0,3,0,3
6142,2021-10-02,Brighton,Arsenal,0,0,D,2021-10-02,1,3,1,1,0,2,1,1,0
6143,2021-10-03,Crystal Palace,Leicester,2,2,D,2021-10-09,2,2,2,2,0,0,1,1,0
6144,2021-10-03,Tottenham,Aston Villa,2,1,H,2021-10-09,2,1,1,1,1,0,3,0,3
6145,2021-10-03,West Ham,Brentford,1,2,A,2021-10-09,1,2,2,2,-1,0,0,3,-3
6146,2021-10-03,Liverpool,Man City,2,2,D,2021-10-09,2,2,2,2,0,0,1,1,0
6147,2021-10-16,Watford,Liverpool,0,5,A,2021-10-16,0,5,5,5,-5,0,0,3,-3
6148,2021-10-16,Aston Villa,Wolves,2,3,A,2021-10-16,2,3,3,3,-1,0,0,3,-3
6149,2021-10-16,Leicester,Man United,4,2,H,2021-10-16,4,2,2,2,2,0,3,0,3
6150,2021-10-16,Man City,Burnley,2,0,H,2021-10-16,2,0,0,0,2,0,3,0,3
6151,2021-10-16,Norwich,Brighton,0,0,D,2021-10-16,0,0,0,0,0,0,1,1,0
6152,2021-10-16,Southampton,Leeds,1,0,H,2021-10-16,1,0,0,0,1,0,3,0,3
6153,2021-10-16,Brentford,Chelsea,0,1,A,2021-10-16,0,1,1,1,-1,0,0,3,-3
6154,2021-10-17,Everton,West Ham,0,1,A,2021-10-23,2,1,6,6,-4,-5,0,3,-3
6155,2021-10-17,Newcastle,Tottenham,2,3,A,2021-10-23,3,3,4,4,-1,-1,0,3,-3
6156,2021-10-18,Arsenal,Crystal Palace,2,2,D,2021-10-23,5,3,3,3,2,0,4,1,3
6157,2021-10-22,Arsenal,Aston Villa,3,1,H,2021-10-23,5,1,3,3,2,-2,4,0,4
6158,2021-10-23,Chelsea,Norwich,7,0,H,2021-10-23,7,0,0,0,7,0,3,0,3
6159,2021-10-23,Crystal Palace,Newcastle,1,1,D,2021-10-23,3,3,3,3,0,0,1,1,0
6160,2021-10-23,Everton,Watford,2,5,A,2021-10-23,2,5,6,6,-4,-1,0,3,-3
6161,2021-10-23,Leeds,Wolves,1,1,D,2021-10-23,1,1,1,1,0,0,1,1,0
6162,2021-10-23,Southampton,Burnley,2,2,D,2021-10-23,2,2,2,2,0,0,1,1,0
6163,2021-10-23,Brighton,Man City,1,4,A,2021-10-23,1,4,4,4,-3,0,0,3,-3
6164,2021-10-24,Brentford,Leicester,1,2,A,2021-10-30,2,2,5,5,-3,-3,0,3,-3
6165,2021-10-24,West Ham,Tottenham,1,0,H,2021-10-30,1,0,0,0,1,0,3,0,3
6166,2021-10-24,Man United,Liverpool,0,5,A,2021-10-30,3,7,5,5,-2,2,0,3,-3
6167,2021-10-30,Leicester,Arsenal,0,2,A,2021-10-30,2,2,3,3,-1,-1,0,3,-3
6168,2021-10-30,Burnley,Brentford,3,1,H,2021-10-30,3,2,1,1,2,1,3,0,3
6169,2021-10-30,Liverpool,Brighton,2,2,D,2021-10-30,7,2,2,2,5,0,1,1,0
6170,2021-10-30,Man City,Crystal Palace,0,2,A,2021-10-30,0,2,2,2,-2,0,0,3,-3
6171,2021-10-30,Newcastle,Chelsea,0,3,A,2021-10-30,0,3,3,3,-3,0,0,3,-3
6172,2021-10-30,Watford,Southampton,0,1,A,2021-10-30,0,1,1,1,-1,0,0,3,-3
6173,2021-10-30,Tottenham,Man United,0,3,A,2021-10-30,0,3,4,4,-4,-1,0,3,-3
6174,2021-10-31,Norwich,Leeds,1,2,A,2021-11-06,3,2,3,3,0,-1,0,3,-3
6175,2021-10-31,Aston Villa,West Ham,1,4,A,2021-11-06,1,4,5,5,-4,-1,0,3,-3
6176,2021-11-01,Wolves,Everton,2,1,H,2021-11-06,2,1,3,3,-1,-2,3,0,3
6177,2021-11-05,Southampton,Aston Villa,1,0,H,2021-11-06,1,1,0,0,1,1,3,0,3
6178,2021-11-06,Man United,Man City,0,2,A,2021-11-06,0,2,2,2,-2,0,0,3,-3
6179,2021-11-06,Brentford,Norwich,1,2,A,2021-11-06,1,3,2,2,-1,1,0,3,-3
6180,2021-11-06,Chelsea,Burnley,1,1,D,2021-11-06,1,1,1,1,0,0,1,1,0
6181,2021-11-06,Crystal Palace,Wolves,2,0,H,2021-11-06,2,2,0,0,2,2,3,0,3
6182,2021-11-06,Brighton,Newcastle,1,1,D,2021-11-06,1,1,1,1,0,0,1,1,0
6183,2021-11-07,Arsenal,Watford,1,0,H,2021-11-13,1,0,0,0,1,0,3,0,3
6184,2021-11-07,Everton,Tottenham,0,0,D,2021-11-13,0,0,0,0,0,0,1,1,0
6185,2021-11-07,Leeds,Leicester,1,1,D,2021-11-13,1,1,1,1,0,0,1,1,0
6186,2021-11-07,West Ham,Liverpool,3,2,H,2021-11-13,3,2,2,2,1,0,3,0,3
6187,2021-11-20,Leicester,Chelsea,0,3,A,2021-11-20,0,3,3,3,-3,0,0,3,-3
6188,2021-11-20,Aston Villa,Brighton,2,0,H,2021-11-20,2,0,0,0,2,0,3,0,3
6189,2021-11-20,Burnley,Crystal Palace,3,3,D,2021-11-20,3,3,3,3,0,0,1,1,0
6190,2021-11-20,Newcastle,Brentford,3,3,D,2021-11-20,3,3,3,3,0,0,1,1,0
6191,2021-11-20,Norwich,Southampton,2,1,H,2021-11-20,2,1,1,1,1,0,3,0,3
6192,2021-11-20,Watford,Man United,4,1,H,2021-11-20,4,1,1,1,3,0,3,0,3
6193,2021-11-20,Wolves,West Ham,1,0,H,2021-11-20,1,0,0,0,1,0,3,0,3
6194,2021-11-20,Liverpool,Arsenal,4,0,H,2021-11-20,4,0,0,0,4,0,3,0,3
6195,2021-11-21,Man City,Everton,3,0,H,2021-11-27,3,0,0,0,3,0,3,0,3
6196,2021-11-21,Tottenham,Leeds,2,1,H,2021-11-27,2,1,1,1,1,0,3,1,2
6197,2021-11-27,Arsenal,Newcastle,2,0,H,2021-11-27,2,0,0,0,2,0,3,0,3
6198,2021-11-27,Crystal Palace,Aston Villa,1,2,A,2021-11-27,1,2,2,2,-1,0,0,3,-3
6199,2021-11-27,Liverpool,Southampton,4,0,H,2021-11-27,4,0,0,0,4,0,3,0,3
6200,2021-11-27,Norwich,Wolves,0,0,D,2021-11-27,0,0,0,0,0,0,1,1,0
6201,2021-11-27,Brighton,Leeds,0,0,D,2021-11-27,0,1,0,0,0,1,1,1,0
6202,2021-11-28,Brentford,Everton,1,0,H,2021-12-04,1,1,0,0,1,1,3,0,3
6203,2021-11-28,Leicester,Watford,4,2,H,2021-12-04,6,3,4,4,2,-1,3,0,3
6204,2021-11-28,Man City,West Ham,2,1,H,2021-12-04,4,2,2,2,2,0,3,0,3
6205,2021-11-28,Chelsea,Man United,1,1,D,2021-12-04,3,1,2,2,1,-1,1,1,0
6206,2021-11-30,Newcastle,Norwich,1,1,D,2021-12-04,1,1,1,1,0,0,1,1,0
6207,2021-11-30,Leeds,Crystal Palace,1,0,H,2021-12-04,1,0,0,0,1,0,3,0,3
6208,2021-12-01,Southampton,Leicester,2,2,D,2021-12-04,2,6,2,2,0,4,1,1,0
6209,2021-12-01,Watford,Chelsea,1,2,A,2021-12-04,3,3,6,6,-3,-3,0,3,-3
6210,2021-12-01,West Ham,Brighton,1,1,D,2021-12-04,2,1,3,3,-1,-2,1,1,0
6211,2021-12-01,Wolves,Burnley,0,0,D,2021-12-04,0,0,0,0,0,0,1,1,0
6212,2021-12-01,Aston Villa,Man City,1,2,A,2021-12-04,1,4,2,2,-1,2,0,3,-3
6213,2021-12-01,Everton,Liverpool,1,4,A,2021-12-04,1,4,5,5,-4,-1,0,3,-3
